Connections;
Exits;
16 16 16 16 16 16 16 16 
16 1 16 1 1 16 1 16 
16 1 16 16 16 16 1 16 
16 1 16 16 16 16 16 16 
16 16 16 0 16 16 1 16 
16 1 16 16 16 16 1 16 
16 1 16 1 1 16 1 16 
16 16 16 16 16 16 16 16 
