Connections;
Exits;
0 0 0 0 0 0 0 0 0 0 0 0 0 0 0 
1 1 1 1 1 1 1 1 1 1 1 1 1 1 1 
1 12 12 12 12 12 12 12 12 12 12 12 12 12 1 
1 12 12 1 1 1 1 1 1 1 1 1 12 12 1 
1 12 12 1 12 12 12 12 12 12 12 1 12 12 1 
1 12 12 1 12 12 12 12 12 13 12 1 12 12 1 
1 12 12 1 12 12 12 12 12 12 12 1 12 12 1 
1 12 12 1 12 12 12 12 12 12 12 1 12 12 1 
1 12 12 1 1 1 12 12 12 1 1 1 12 12 1 
1 12 12 12 12 12 12 12 12 12 12 12 12 12 1 
1 1 1 1 1 13 12 12 12 13 1 1 1 1 1 
