connections=[
		],
events={
	{
		exits:[ (25.43), (25.43), (25.43), (25.43), (25.43), (25.43), (25.43), (25.43), (25.42),		]},
	{
		NPCs:[
			{is_trainer:0,b1:7,b2:0,sprite:49},
			{is_trainer:0,b1:3,b2:0,sprite:49},
			{is_trainer:0,b1:8,b2:0,sprite:21},
			{is_trainer:0,b1:1,b2:0,sprite:211},
			{is_trainer:0,b1:9,b2:0,sprite:219},
		]},
	{
		signs:[
			{x:2,y:1},
			{x:4,y:1},
			{x:6,y:1},
			{x:8,y:1},
			{x:10,y:1},
			{x:12,y:1},
			{x:14,y:1},
			{x:16,y:1},
			{x:5,y:9},
			{x:8,y:9},
			{x:11,y:9},
			{x:14,y:9},
		]},
	{
		triggers:[
		]},

},
[
	[1, 1, 1, 1, 1, 1, 1, 1, 1, 1, 1, 1, 1, 1, 1, 1, 1, 1, ],
	[1, 1, 1, 1, 1, 1, 1, 1, 1, 1, 1, 1, 1, 1, 1, 1, 1, 1, ],
	[1, 12, 12, 12, 12, 12, 12, 12, 12, 12, 12, 12, 12, 12, 12, 12, 12, 13, ],
	[1, 12, 12, 12, 12, 12, 12, 12, 12, 12, 12, 12, 12, 12, 12, 12, 12, 12, ],
	[1, 12, 12, 1, 1, 1, 1, 1, 1, 1, 1, 1, 1, 1, 1, 12, 12, 12, ],
	[1, 12, 12, 1, 1, 1, 1, 1, 1, 1, 1, 1, 1, 1, 1, 12, 12, 12, ],
	[1, 12, 12, 1, 1, 1, 1, 1, 1, 1, 1, 1, 1, 1, 1, 12, 12, 12, ],
	[1, 12, 12, 1, 1, 1, 1, 1, 1, 1, 1, 1, 1, 1, 1, 12, 12, 12, ],
	[1, 12, 12, 1, 1, 1, 1, 1, 1, 1, 1, 1, 1, 1, 1, 12, 12, 12, ],
	[1, 12, 12, 1, 13, 1, 1, 13, 1, 1, 13, 1, 1, 13, 1, 12, 12, 12, ],
	[1, 12, 12, 12, 12, 12, 12, 12, 12, 12, 12, 12, 12, 12, 12, 12, 12, 12, ],
	[1, 12, 12, 12, 12, 12, 12, 12, 12, 12, 12, 12, 12, 12, 12, 12, 12, 12, ],
	[1, 1, 1, 1, 1, 1, 1, 1, 1, 1, 1, 1, 1, 1, 1, 1, 1, 1, ],
]
