Connections;
Exits;
1 16 16 16 1 16 16 16 
1 16 1 16 1 16 1 16 
1 16 1 16 1 16 1 16 
16 16 16 16 1 16 1 16 
0 16 0 16 16 16 16 16 
1 16 1 16 1 0 1 16 
1 16 1 16 1 16 1 16 
16 16 1 16 16 16 1 16 
