connections=[
		],
events={
	
		'exits':[		],
	
		'NPCs':[
			{'is_trainer':0,'b1':9,'b2':0,'sprite':'28','x':9,'y':3},
		],
	
		'signs':[
		],
	
		'triggers':[
			{'x':3,'y':5,'flag':16384,'scriptPointer':2585460},
			{'x':10,'y':5,'flag':16384,'scriptPointer':2585470},
		],

},
partial_map=[
	[1, 1, 1, 1, 1, 1, 1, 1, 1, 1, 1, 1, 1, 1, ],
	[1, 1, 1, 1, 1, 1, 1, 1, 1, 1, 1, 1, 1, 1, ],
	[1, 1, 1, 1, 1, 1, 1, 1, 1, 1, 1, 1, 1, 1, ],
	[1, 12, 12, 12, 12, 12, 12, 12, 12, 12, 12, 12, 12, 1, ],
	[1, 12, 12, 12, 12, 12, 12, 12, 12, 12, 12, 12, 12, 1, ],
	[1, 12, 12, 12, 12, 12, 12, 12, 12, 12, 12, 12, 12, 1, ],
	[1, 12, 12, 12, 12, 12, 12, 12, 12, 12, 12, 12, 12, 1, ],
	[1, 12, 12, 12, 12, 12, 12, 12, 12, 12, 12, 12, 12, 1, ],
	[1, 1, 1, 1, 1, 1, 12, 12, 1, 1, 1, 1, 1, 1, ],
]
