Connections;
Exits; (25.41); (25.41); (25.41); (25.41); (25.41); (25.41); (25.41); (25.41); (25.41); (25.41); (25.41); (25.41);
1 1 1 1 1 1 1 1 1 1 1 1 1 1 1 1 1 1 1 1 1 1 1 1 1 1 1 1 1 1 1 1 1 1 1 1 
1 1 1 1 1 1 1 1 1 1 1 1 1 1 1 1 1 1 1 1 1 1 1 1 1 1 1 1 1 1 1 1 1 1 1 1 
1 1 1 12 12 12 1 1 1 1 1 1 12 12 12 1 1 1 1 1 1 12 12 12 12 12 1 1 1 1 12 12 12 1 1 1 
1 1 1 12 12 12 1 1 1 1 1 1 12 12 12 1 1 1 1 1 1 12 12 12 12 12 1 1 1 1 12 12 12 1 1 1 
1 0 12 12 12 12 12 12 1 1 0 12 12 12 12 12 12 1 1 12 12 12 12 12 12 12 1 1 13 12 12 12 12 12 12 1 
1 12 12 12 12 12 12 12 1 1 13 12 12 1 1 12 12 1 1 12 12 12 1 1 12 12 1 1 12 12 12 12 12 12 12 1 
1 12 12 12 12 1 1 12 1 1 12 12 12 1 1 12 12 1 1 12 12 12 1 1 12 12 1 1 12 12 12 12 12 1 1 1 
1 12 12 12 12 1 1 1 1 1 12 12 12 12 12 12 12 1 1 12 12 12 12 1 12 12 1 1 12 12 12 12 12 1 1 1 
1 1 1 1 1 1 1 1 1 1 1 1 1 1 1 1 1 1 1 1 1 1 1 1 1 1 1 1 1 1 1 1 1 1 1 1 
1 1 1 1 1 1 1 1 1 1 1 1 1 1 1 1 1 1 1 1 1 1 1 1 1 1 1 1 1 1 1 1 1 1 1 1 
1 1 1 1 1 1 1 1 1 1 1 1 1 1 1 1 1 1 1 1 1 1 1 1 1 1 1 1 1 1 1 1 1 1 1 1 
1 1 1 12 12 12 1 1 1 1 12 12 12 12 12 1 1 1 1 13 13 12 12 12 1 1 1 1 1 1 12 12 12 12 12 1 
1 1 1 12 12 12 1 1 1 1 12 1 1 12 12 1 1 1 1 1 1 12 12 12 1 1 1 1 1 1 12 1 1 1 1 1 
1 0 12 12 12 12 12 12 1 1 12 1 1 12 12 12 13 1 1 12 12 12 12 12 12 12 1 1 1 12 12 1 1 1 1 1 
1 12 12 12 12 12 12 12 1 1 12 12 12 12 12 12 12 1 1 12 12 12 12 12 12 12 1 1 12 12 12 12 12 12 12 1 
1 12 12 12 12 12 12 12 1 1 12 12 12 12 12 12 12 1 1 12 12 12 12 12 12 12 1 1 12 12 12 12 12 12 12 1 
1 12 12 12 0 0 12 12 1 1 12 12 12 0 0 12 12 1 1 12 12 12 0 0 12 12 1 1 12 12 12 0 0 12 12 1 
1 1 1 1 1 1 1 1 1 1 1 1 1 1 1 1 1 1 1 1 1 1 1 1 1 1 1 1 1 1 1 1 1 1 1 1 
