connections=[
		],
events={
	{
		exits:[ (25.41),		]},
	{
		NPCs:[
			{is_trainer:1,b1:46,b2:0,sprite:49},
			{is_trainer:1,b1:50,b2:0,sprite:49},
		]},
	{
		signs:[
			{x:0,y:2},
		]},
	{
		triggers:[
		]},

},
[
	[1, 1, 1, 1, 1, 1, 1, 1, 1, 1, 1, 1, 1, 1, 1, 1, 1, ],
	[1, 1, 1, 1, 1, 1, 1, 1, 1, 1, 1, 1, 1, 1, 1, 1, 1, ],
	[1, 12, 1, 1, 12, 12, 1, 1, 12, 1, 1, 1, 1, 12, 12, 12, 1, ],
	[12, 12, 1, 1, 12, 12, 1, 1, 12, 12, 1, 1, 1, 12, 12, 12, 12, ],
	[12, 12, 12, 12, 12, 12, 12, 12, 12, 12, 12, 12, 12, 12, 12, 12, 12, ],
	[12, 12, 12, 12, 12, 12, 12, 12, 12, 12, 12, 12, 12, 12, 12, 12, 12, ],
	[12, 1, 1, 1, 1, 1, 1, 12, 1, 1, 12, 1, 1, 1, 12, 12, 12, ],
	[12, 1, 1, 1, 1, 1, 1, 12, 1, 1, 12, 1, 1, 1, 12, 12, 12, ],
	[12, 12, 12, 12, 12, 12, 12, 12, 12, 12, 12, 12, 12, 12, 12, 12, 12, ],
	[12, 12, 12, 12, 12, 12, 12, 12, 12, 12, 12, 12, 12, 12, 12, 12, 12, ],
	[12, 12, 12, 12, 12, 12, 12, 12, 12, 12, 12, 12, 12, 12, 12, 1, 1, ],
	[12, 1, 1, 1, 1, 1, 1, 12, 1, 1, 12, 1, 1, 12, 12, 13, 13, ],
	[1, 1, 1, 1, 1, 1, 1, 12, 12, 12, 12, 12, 12, 12, 12, 1, 1, ],
]
