Connections;
Exits; (25.41);
1 1 1 1 1 1 1 1 1 1 1 1 1 1 1 1 1 
1 1 1 1 1 1 1 1 1 1 1 1 1 1 1 1 1 
1 12 1 1 12 12 1 1 12 1 1 1 1 12 12 12 1 
12 12 1 1 12 12 1 1 12 12 1 1 1 12 12 12 12 
12 12 12 12 12 12 12 12 12 12 12 12 12 12 12 12 12 
12 12 12 12 12 12 12 12 12 12 12 12 12 12 12 12 12 
12 1 1 1 1 1 1 12 1 1 12 1 1 1 12 12 12 
12 1 1 1 1 1 1 12 1 1 12 1 1 1 12 12 12 
12 12 12 12 12 12 12 12 12 12 12 12 12 12 12 12 12 
12 12 12 12 12 12 12 12 12 12 12 12 12 12 12 12 12 
12 12 12 12 12 12 12 12 12 12 12 12 12 12 12 1 1 
12 1 1 1 1 1 1 12 1 1 12 1 1 12 12 13 13 
1 1 1 1 1 1 1 12 12 12 12 12 12 12 12 1 1 
