connections=[
		],
events={
	
		'exits':[{'name':' (25.41)','x':4,'y':16},{'name':' (25.41)','x':5,'y':16},{'name':' (25.41)','x':13,'y':16},{'name':' (25.41)','x':14,'y':16},{'name':' (25.41)','x':22,'y':16},{'name':' (25.41)','x':23,'y':16},{'name':' (25.41)','x':31,'y':16},{'name':' (25.41)','x':32,'y':16},{'name':' (25.41)','x':4,'y':1},{'name':' (25.41)','x':13,'y':1},{'name':' (25.41)','x':22,'y':1},{'name':' (25.41)','x':31,'y':1},		],
	
		'NPCs':[
			{'is_trainer':1,'b1':10,'b2':0,'sprite':'25','x':4,'y':7},
			{'is_trainer':1,'b1':9,'b2':0,'sprite':'48','x':34,'y':11},
			{'is_trainer':1,'b1':10,'b2':0,'sprite':'48','x':21,'y':5},
			{'is_trainer':1,'b1':8,'b2':0,'sprite':'65','x':5,'y':14},
			{'is_trainer':1,'b1':8,'b2':0,'sprite':'26','x':4,'y':14},
			{'is_trainer':1,'b1':8,'b2':0,'sprite':'15','x':22,'y':11},
			{'is_trainer':1,'b1':9,'b2':0,'sprite':'20','x':15,'y':6},
			{'is_trainer':0,'b1':7,'b2':0,'sprite':'39','x':28,'y':5},
		],
	
		'signs':[
			{'x':15,'y':11},
			{'x':15,'y':12},
		],
	
		'triggers':[
		],

},
partial_map=[
	[1, 1, 1, 1, 1, 1, 1, 1, 1, 1, 1, 1, 1, 1, 1, 1, 1, 1, 1, 1, 1, 1, 1, 1, 1, 1, 1, 1, 1, 1, 1, 1, 1, 1, 1, 1, ],
	[1, 1, 1, 1, 1, 1, 1, 1, 1, 1, 1, 1, 1, 1, 1, 1, 1, 1, 1, 1, 1, 1, 1, 1, 1, 1, 1, 1, 1, 1, 1, 1, 1, 1, 1, 1, ],
	[1, 1, 1, 12, 12, 12, 1, 1, 1, 1, 1, 1, 12, 12, 12, 1, 1, 1, 1, 1, 1, 12, 12, 12, 12, 12, 1, 1, 1, 1, 12, 12, 12, 1, 1, 1, ],
	[1, 1, 1, 12, 12, 12, 1, 1, 1, 1, 1, 1, 12, 12, 12, 1, 1, 1, 1, 1, 1, 12, 12, 12, 12, 12, 1, 1, 1, 1, 12, 12, 12, 1, 1, 1, ],
	[1, 0, 12, 12, 12, 12, 12, 12, 1, 1, 0, 12, 12, 12, 12, 12, 12, 1, 1, 12, 12, 12, 12, 12, 12, 12, 1, 1, 13, 12, 12, 12, 12, 12, 12, 1, ],
	[1, 12, 12, 12, 12, 12, 12, 12, 1, 1, 13, 12, 12, 1, 1, 12, 12, 1, 1, 12, 12, 12, 1, 1, 12, 12, 1, 1, 12, 12, 12, 12, 12, 12, 12, 1, ],
	[1, 12, 12, 12, 12, 1, 1, 12, 1, 1, 12, 12, 12, 1, 1, 12, 12, 1, 1, 12, 12, 12, 1, 1, 12, 12, 1, 1, 12, 12, 12, 12, 12, 1, 1, 1, ],
	[1, 12, 12, 12, 12, 1, 1, 1, 1, 1, 12, 12, 12, 12, 12, 12, 12, 1, 1, 12, 12, 12, 12, 1, 12, 12, 1, 1, 12, 12, 12, 12, 12, 1, 1, 1, ],
	[1, 1, 1, 1, 1, 1, 1, 1, 1, 1, 1, 1, 1, 1, 1, 1, 1, 1, 1, 1, 1, 1, 1, 1, 1, 1, 1, 1, 1, 1, 1, 1, 1, 1, 1, 1, ],
	[1, 1, 1, 1, 1, 1, 1, 1, 1, 1, 1, 1, 1, 1, 1, 1, 1, 1, 1, 1, 1, 1, 1, 1, 1, 1, 1, 1, 1, 1, 1, 1, 1, 1, 1, 1, ],
	[1, 1, 1, 1, 1, 1, 1, 1, 1, 1, 1, 1, 1, 1, 1, 1, 1, 1, 1, 1, 1, 1, 1, 1, 1, 1, 1, 1, 1, 1, 1, 1, 1, 1, 1, 1, ],
	[1, 1, 1, 12, 12, 12, 1, 1, 1, 1, 12, 12, 12, 12, 12, 1, 1, 1, 1, 13, 13, 12, 12, 12, 1, 1, 1, 1, 1, 1, 12, 12, 12, 12, 12, 1, ],
	[1, 1, 1, 12, 12, 12, 1, 1, 1, 1, 12, 1, 1, 12, 12, 1, 1, 1, 1, 1, 1, 12, 12, 12, 1, 1, 1, 1, 1, 1, 12, 1, 1, 1, 1, 1, ],
	[1, 0, 12, 12, 12, 12, 12, 12, 1, 1, 12, 1, 1, 12, 12, 12, 13, 1, 1, 12, 12, 12, 12, 12, 12, 12, 1, 1, 1, 12, 12, 1, 1, 1, 1, 1, ],
	[1, 12, 12, 12, 12, 12, 12, 12, 1, 1, 12, 12, 12, 12, 12, 12, 12, 1, 1, 12, 12, 12, 12, 12, 12, 12, 1, 1, 12, 12, 12, 12, 12, 12, 12, 1, ],
	[1, 12, 12, 12, 12, 12, 12, 12, 1, 1, 12, 12, 12, 12, 12, 12, 12, 1, 1, 12, 12, 12, 12, 12, 12, 12, 1, 1, 12, 12, 12, 12, 12, 12, 12, 1, ],
	[1, 12, 12, 12, 0, 0, 12, 12, 1, 1, 12, 12, 12, 0, 0, 12, 12, 1, 1, 12, 12, 12, 0, 0, 12, 12, 1, 1, 12, 12, 12, 0, 0, 12, 12, 1, ],
	[1, 1, 1, 1, 1, 1, 1, 1, 1, 1, 1, 1, 1, 1, 1, 1, 1, 1, 1, 1, 1, 1, 1, 1, 1, 1, 1, 1, 1, 1, 1, 1, 1, 1, 1, 1, ],
]
