connections=[
		],
events={
	
		'exits':[{'name':' (25.41)','x':15,'y':2},		],
	
		'NPCs':[
			{'is_trainer':1,'b1':46,'b2':0,'sprite':'49','x':10,'y':4},
			{'is_trainer':1,'b1':50,'b2':0,'sprite':'49','x':7,'y':4},
		],
	
		'signs':[
			{'x':0,'y':2},
		],
	
		'triggers':[
		],

},
partial_map=[
	[1, 1, 1, 1, 1, 1, 1, 1, 1, 1, 1, 1, 1, 1, 1, 1, 1, ],
	[1, 1, 1, 1, 1, 1, 1, 1, 1, 1, 1, 1, 1, 1, 1, 1, 1, ],
	[1, 12, 1, 1, 12, 12, 1, 1, 12, 1, 1, 1, 1, 12, 12, 12, 1, ],
	[12, 12, 1, 1, 12, 12, 1, 1, 12, 12, 1, 1, 1, 12, 12, 12, 12, ],
	[12, 12, 12, 12, 12, 12, 12, 12, 12, 12, 12, 12, 12, 12, 12, 12, 12, ],
	[12, 12, 12, 12, 12, 12, 12, 12, 12, 12, 12, 12, 12, 12, 12, 12, 12, ],
	[12, 1, 1, 1, 1, 1, 1, 12, 1, 1, 12, 1, 1, 1, 12, 12, 12, ],
	[12, 1, 1, 1, 1, 1, 1, 12, 1, 1, 12, 1, 1, 1, 12, 12, 12, ],
	[12, 12, 12, 12, 12, 12, 12, 12, 12, 12, 12, 12, 12, 12, 12, 12, 12, ],
	[12, 12, 12, 12, 12, 12, 12, 12, 12, 12, 12, 12, 12, 12, 12, 12, 12, ],
	[12, 12, 12, 12, 12, 12, 12, 12, 12, 12, 12, 12, 12, 12, 12, 1, 1, ],
	[12, 1, 1, 1, 1, 1, 1, 12, 1, 1, 12, 1, 1, 12, 12, 13, 13, ],
	[1, 1, 1, 1, 1, 1, 1, 12, 12, 12, 12, 12, 12, 12, 12, 1, 1, ],
]
