connections=[
		],
events={
	{
		exits:[ABANDONED SHIP (24.54),ABANDONED SHIP (24.54),ABANDONED SHIP (24.54),ABANDONED SHIP (24.54),ABANDONED SHIP (24.56),ABANDONED SHIP (24.56),ABANDONED SHIP (24.56),ABANDONED SHIP (24.56),ABANDONED SHIP (24.62),ABANDONED SHIP (24.57),ABANDONED SHIP (24.57),ABANDONED SHIP (24.62),		]},
	{
		NPCs:[
			{is_trainer:0,b1:2,b2:0,sprite:35},
			{is_trainer:1,b1:45,b2:0,sprite:54},
		]},
	{
		signs:[
		]},
	{
		triggers:[
		]},

},
[
	[1, 1, 1, 1, 1, 1, 1, 1, 1, 1, 1, 1, 1, 1, 1, 1, 1, 1, ],
	[1, 1, 1, 1, 1, 1, 1, 1, 1, 1, 1, 1, 1, 1, 1, 1, 1, 1, ],
	[12, 12, 12, 12, 12, 12, 13, 1, 13, 12, 12, 12, 12, 12, 12, 12, 12, 13, ],
	[12, 12, 12, 12, 12, 12, 12, 1, 12, 12, 12, 12, 12, 12, 12, 12, 12, 12, ],
	[13, 12, 1, 1, 1, 12, 12, 1, 12, 12, 1, 1, 1, 1, 1, 1, 12, 12, ],
	[12, 12, 1, 1, 1, 12, 12, 1, 12, 12, 1, 1, 1, 1, 1, 1, 12, 12, ],
	[12, 12, 1, 1, 1, 12, 12, 1, 12, 12, 1, 1, 1, 1, 1, 1, 12, 12, ],
	[12, 12, 1, 1, 1, 12, 12, 1, 12, 12, 1, 1, 1, 1, 1, 1, 12, 12, ],
	[13, 12, 1, 1, 1, 12, 12, 1, 12, 12, 1, 0, 1, 1, 1, 1, 12, 12, ],
	[12, 12, 1, 13, 1, 12, 12, 1, 12, 12, 1, 12, 1, 1, 13, 1, 12, 13, ],
	[12, 12, 12, 12, 12, 12, 12, 1, 12, 12, 12, 12, 12, 12, 12, 12, 12, 12, ],
	[12, 12, 12, 12, 12, 12, 12, 1, 12, 12, 12, 12, 12, 12, 12, 12, 12, 12, ],
]
