connections=[
		],
events={
	{
		exits:[ABANDONED SHIP (24.54),ABANDONED SHIP (24.54),		]},
	{
		NPCs:[
			{is_trainer:0,b1:8,b2:0,sprite:46},
			{is_trainer:0,b1:1,b2:0,sprite:59},
		]},
	{
		signs:[
		]},
	{
		triggers:[
		]},

},
[
	[1, 1, 1, 1, 1, 1, 1, 1, 1, ],
	[1, 1, 1, 1, 1, 1, 1, 1, 1, ],
	[12, 12, 12, 12, 12, 12, 12, 1, 1, ],
	[13, 12, 12, 12, 12, 12, 12, 12, 12, ],
	[13, 12, 12, 12, 12, 12, 12, 12, 12, ],
	[12, 12, 12, 13, 13, 12, 12, 12, 12, ],
	[12, 12, 12, 13, 13, 12, 12, 12, 12, ],
]
