connections=[
		],
events={
	
		'exits':[{'name':'ABANDONED SHIP (24.65)','x':6,'y':14},{'name':'ABANDONED SHIP (24.65)','x':7,'y':14},{'name':'ABANDONED SHIP (24.65)','x':21,'y':14},{'name':'ABANDONED SHIP (24.65)','x':22,'y':14},{'name':'ABANDONED SHIP (24.65)','x':36,'y':14},{'name':'ABANDONED SHIP (24.65)','x':37,'y':14},{'name':'ABANDONED SHIP (24.65)','x':6,'y':1},{'name':'ABANDONED SHIP (24.65)','x':21,'y':1},{'name':'ABANDONED SHIP (24.65)','x':36,'y':1},		],
	
		'NPCs':[
			{'is_trainer':0,'b1':1,'b2':0,'sprite':'59','x':41,'y':4},
			{'is_trainer':0,'b1':1,'b2':0,'sprite':'59','x':16,'y':10},
			{'is_trainer':0,'b1':1,'b2':0,'sprite':'59','x':5,'y':11},
			{'is_trainer':0,'b1':1,'b2':0,'sprite':'59','x':31,'y':11},
		],
	
		'signs':[
			{'x':42,'y':10},
			{'x':20,'y':5},
			{'x':1,'y':12},
			{'x':1,'y':2},
			{'x':8,'y':5},
			{'x':11,'y':3},
			{'x':10,'y':10},
			{'x':16,'y':3},
			{'x':25,'y':2},
			{'x':24,'y':6},
		],
	
		'triggers':[
		],

},
partial_map=[
	[1, 1, 1, 1, 1, 1, 1, 1, 1, 1, 1, 1, 1, 1, 1, 1, 1, 1, 1, 1, 1, 0, 1, 1, 1, 1, 1, 1, 1, 1, 1, 1, 1, 1, 1, 1, 1, 1, 1, 1, 1, 1, 1, 1, ],
	[1, 1, 1, 1, 1, 1, 13, 1, 1, 1, 1, 1, 1, 1, 1, 1, 1, 1, 1, 1, 1, 12, 1, 1, 1, 1, 1, 1, 1, 1, 1, 1, 1, 1, 1, 1, 13, 1, 1, 1, 1, 1, 1, 1, ],
	[1, 1, 12, 12, 12, 12, 12, 12, 12, 12, 12, 12, 12, 1, 1, 12, 12, 12, 13, 13, 1, 12, 13, 13, 12, 12, 12, 12, 1, 1, 12, 12, 12, 12, 12, 12, 12, 12, 12, 12, 13, 13, 12, 1, ],
	[1, 12, 12, 12, 12, 12, 12, 12, 12, 12, 12, 12, 13, 1, 1, 13, 12, 12, 13, 13, 12, 1, 13, 13, 12, 12, 12, 12, 12, 12, 12, 12, 12, 13, 12, 12, 12, 12, 12, 12, 13, 13, 12, 1, ],
	[1, 12, 12, 13, 13, 12, 12, 12, 12, 12, 12, 12, 12, 1, 1, 12, 12, 12, 12, 12, 12, 12, 12, 12, 12, 12, 12, 12, 1, 1, 12, 12, 12, 12, 12, 12, 12, 12, 12, 12, 12, 12, 12, 1, ],
	[1, 13, 12, 13, 13, 12, 12, 12, 12, 12, 12, 12, 12, 1, 1, 12, 12, 12, 12, 12, 12, 12, 12, 12, 12, 12, 12, 12, 1, 1, 13, 12, 13, 13, 12, 12, 12, 12, 13, 12, 12, 12, 12, 1, ],
	[1, 12, 12, 12, 12, 12, 12, 12, 12, 12, 12, 12, 12, 1, 1, 12, 12, 12, 12, 12, 12, 12, 12, 12, 12, 12, 12, 12, 1, 1, 12, 12, 13, 13, 12, 12, 12, 12, 12, 12, 12, 12, 13, 1, ],
	[1, 1, 1, 1, 1, 1, 1, 1, 1, 1, 1, 1, 1, 1, 1, 1, 1, 1, 1, 1, 1, 1, 1, 1, 1, 1, 1, 1, 1, 1, 1, 1, 1, 1, 1, 1, 1, 1, 1, 1, 1, 1, 1, 1, ],
	[1, 1, 1, 1, 1, 1, 1, 1, 1, 1, 1, 1, 1, 1, 1, 1, 1, 1, 1, 1, 1, 1, 1, 1, 1, 1, 1, 1, 1, 1, 1, 1, 1, 1, 1, 1, 1, 1, 1, 1, 1, 1, 1, 1, ],
	[1, 1, 1, 1, 1, 1, 1, 1, 1, 1, 1, 1, 1, 1, 1, 1, 1, 1, 1, 1, 1, 1, 1, 1, 1, 1, 1, 1, 1, 1, 1, 1, 1, 1, 1, 1, 1, 1, 1, 1, 1, 1, 1, 1, ],
	[1, 12, 12, 12, 12, 12, 12, 1, 12, 12, 12, 12, 12, 1, 1, 12, 12, 12, 12, 12, 12, 12, 12, 12, 12, 12, 12, 12, 1, 1, 12, 12, 12, 12, 12, 12, 12, 12, 12, 12, 13, 13, 12, 1, ],
	[1, 12, 12, 12, 12, 12, 12, 12, 12, 12, 13, 13, 12, 1, 1, 12, 12, 12, 12, 12, 12, 12, 12, 12, 12, 13, 12, 13, 1, 1, 13, 12, 12, 12, 12, 13, 13, 12, 12, 12, 13, 13, 12, 1, ],
	[1, 12, 12, 12, 12, 12, 12, 12, 12, 12, 13, 13, 12, 1, 1, 12, 12, 12, 12, 12, 12, 12, 12, 12, 12, 12, 12, 12, 1, 1, 12, 12, 12, 12, 12, 13, 13, 12, 12, 12, 12, 12, 12, 1, ],
	[1, 13, 12, 12, 12, 12, 12, 12, 12, 12, 12, 12, 12, 1, 1, 12, 13, 13, 12, 12, 12, 12, 12, 12, 12, 12, 12, 12, 1, 1, 12, 12, 12, 12, 12, 12, 12, 12, 12, 12, 12, 12, 13, 1, ],
	[1, 12, 12, 12, 12, 12, 12, 12, 12, 12, 12, 12, 13, 1, 1, 12, 13, 13, 12, 12, 12, 12, 12, 12, 12, 12, 12, 12, 1, 1, 12, 12, 12, 13, 12, 12, 12, 12, 12, 12, 12, 12, 12, 1, ],
]
