connections=[
		],
events={
	{
		exits:[ABANDONED SHIP (24.55),ABANDONED SHIP (24.55),ABANDONED SHIP (24.55),ABANDONED SHIP (24.55),ABANDONED SHIP (24.55),ABANDONED SHIP (24.55),		]},
	{
		NPCs:[
			{is_trainer:0,b1:2,b2:0,sprite:48},
			{is_trainer:0,b1:1,b2:0,sprite:59},
			{is_trainer:1,b1:8,b2:0,sprite:45},
			{is_trainer:1,b1:16,b2:0,sprite:35},
		]},
	{
		signs:[
		]},
	{
		triggers:[
		]},

},
[
	[1, 1, 1, 1, 1, 1, 1, 1, 1, 1, 1, 1, 1, 1, 1, 1, 1, 1, ],
	[1, 1, 1, 1, 13, 1, 1, 1, 1, 1, 1, 1, 1, 13, 1, 1, 1, 1, ],
	[1, 12, 12, 12, 12, 12, 12, 12, 1, 1, 1, 1, 12, 12, 12, 12, 12, 1, ],
	[1, 12, 12, 12, 12, 12, 12, 12, 1, 1, 1, 1, 12, 12, 12, 12, 13, 1, ],
	[1, 13, 12, 12, 12, 12, 12, 12, 1, 1, 12, 12, 12, 12, 12, 12, 12, 1, ],
	[1, 12, 12, 12, 12, 12, 12, 12, 1, 1, 12, 12, 12, 12, 12, 12, 12, 1, ],
	[1, 12, 1, 12, 12, 12, 12, 12, 1, 1, 13, 12, 12, 12, 12, 12, 12, 1, ],
	[1, 12, 12, 12, 12, 12, 12, 12, 1, 1, 12, 12, 12, 12, 12, 12, 12, 1, ],
	[1, 1, 1, 1, 1, 1, 1, 1, 1, 1, 1, 1, 1, 12, 1, 1, 1, 1, ],
	[1, 1, 1, 1, 1, 1, 1, 1, 1, 1, 1, 1, 1, 12, 1, 1, 1, 1, ],
	[1, 1, 1, 1, 1, 1, 1, 1, 1, 1, 1, 1, 1, 12, 1, 1, 1, 1, ],
	[1, 1, 1, 12, 12, 12, 12, 12, 1, 1, 12, 12, 12, 12, 12, 1, 1, 1, ],
	[1, 1, 1, 12, 12, 12, 12, 12, 1, 1, 12, 12, 12, 12, 12, 1, 1, 1, ],
	[1, 12, 12, 12, 1, 12, 12, 12, 12, 12, 12, 12, 12, 12, 12, 12, 12, 1, ],
	[1, 12, 12, 12, 12, 12, 12, 12, 1, 1, 12, 1, 1, 12, 12, 12, 13, 1, ],
	[1, 12, 12, 12, 12, 12, 12, 12, 1, 1, 12, 1, 1, 12, 12, 12, 12, 1, ],
	[1, 13, 12, 12, 12, 12, 12, 12, 1, 1, 12, 12, 12, 12, 12, 12, 12, 1, ],
]
