connections=[
		],
events={
	{
		exits:[ABANDONED SHIP (24.65),ABANDONED SHIP (24.65),ABANDONED SHIP (24.65),ABANDONED SHIP (24.65),ABANDONED SHIP (24.65),ABANDONED SHIP (24.65),ABANDONED SHIP (24.65),ABANDONED SHIP (24.65),ABANDONED SHIP (24.65),		]},
	{
		NPCs:[
			{is_trainer:0,b1:1,b2:0,sprite:59},
			{is_trainer:0,b1:1,b2:0,sprite:59},
			{is_trainer:0,b1:1,b2:0,sprite:59},
			{is_trainer:0,b1:1,b2:0,sprite:59},
		]},
	{
		signs:[
			{x:42,y:10},
			{x:20,y:5},
			{x:1,y:12},
			{x:1,y:2},
			{x:8,y:5},
			{x:11,y:3},
			{x:10,y:10},
			{x:16,y:3},
			{x:25,y:2},
			{x:24,y:6},
		]},
	{
		triggers:[
		]},

},
[
	[1, 1, 1, 1, 1, 1, 1, 1, 1, 1, 1, 1, 1, 1, 1, 1, 1, 1, 1, 1, 1, 0, 1, 1, 1, 1, 1, 1, 1, 1, 1, 1, 1, 1, 1, 1, 1, 1, 1, 1, 1, 1, 1, 1, ],
	[1, 1, 1, 1, 1, 1, 13, 1, 1, 1, 1, 1, 1, 1, 1, 1, 1, 1, 1, 1, 1, 12, 1, 1, 1, 1, 1, 1, 1, 1, 1, 1, 1, 1, 1, 1, 13, 1, 1, 1, 1, 1, 1, 1, ],
	[1, 1, 12, 12, 12, 12, 12, 12, 12, 12, 12, 12, 12, 1, 1, 12, 12, 12, 13, 13, 1, 12, 13, 13, 12, 12, 12, 12, 1, 1, 12, 12, 12, 12, 12, 12, 12, 12, 12, 12, 13, 13, 12, 1, ],
	[1, 12, 12, 12, 12, 12, 12, 12, 12, 12, 12, 12, 13, 1, 1, 13, 12, 12, 13, 13, 12, 1, 13, 13, 12, 12, 12, 12, 12, 12, 12, 12, 12, 13, 12, 12, 12, 12, 12, 12, 13, 13, 12, 1, ],
	[1, 12, 12, 13, 13, 12, 12, 12, 12, 12, 12, 12, 12, 1, 1, 12, 12, 12, 12, 12, 12, 12, 12, 12, 12, 12, 12, 12, 1, 1, 12, 12, 12, 12, 12, 12, 12, 12, 12, 12, 12, 12, 12, 1, ],
	[1, 13, 12, 13, 13, 12, 12, 12, 12, 12, 12, 12, 12, 1, 1, 12, 12, 12, 12, 12, 12, 12, 12, 12, 12, 12, 12, 12, 1, 1, 13, 12, 13, 13, 12, 12, 12, 12, 13, 12, 12, 12, 12, 1, ],
	[1, 12, 12, 12, 12, 12, 12, 12, 12, 12, 12, 12, 12, 1, 1, 12, 12, 12, 12, 12, 12, 12, 12, 12, 12, 12, 12, 12, 1, 1, 12, 12, 13, 13, 12, 12, 12, 12, 12, 12, 12, 12, 13, 1, ],
	[1, 1, 1, 1, 1, 1, 1, 1, 1, 1, 1, 1, 1, 1, 1, 1, 1, 1, 1, 1, 1, 1, 1, 1, 1, 1, 1, 1, 1, 1, 1, 1, 1, 1, 1, 1, 1, 1, 1, 1, 1, 1, 1, 1, ],
	[1, 1, 1, 1, 1, 1, 1, 1, 1, 1, 1, 1, 1, 1, 1, 1, 1, 1, 1, 1, 1, 1, 1, 1, 1, 1, 1, 1, 1, 1, 1, 1, 1, 1, 1, 1, 1, 1, 1, 1, 1, 1, 1, 1, ],
	[1, 1, 1, 1, 1, 1, 1, 1, 1, 1, 1, 1, 1, 1, 1, 1, 1, 1, 1, 1, 1, 1, 1, 1, 1, 1, 1, 1, 1, 1, 1, 1, 1, 1, 1, 1, 1, 1, 1, 1, 1, 1, 1, 1, ],
	[1, 12, 12, 12, 12, 12, 12, 1, 12, 12, 12, 12, 12, 1, 1, 12, 12, 12, 12, 12, 12, 12, 12, 12, 12, 12, 12, 12, 1, 1, 12, 12, 12, 12, 12, 12, 12, 12, 12, 12, 13, 13, 12, 1, ],
	[1, 12, 12, 12, 12, 12, 12, 12, 12, 12, 13, 13, 12, 1, 1, 12, 12, 12, 12, 12, 12, 12, 12, 12, 12, 13, 12, 13, 1, 1, 13, 12, 12, 12, 12, 13, 13, 12, 12, 12, 13, 13, 12, 1, ],
	[1, 12, 12, 12, 12, 12, 12, 12, 12, 12, 13, 13, 12, 1, 1, 12, 12, 12, 12, 12, 12, 12, 12, 12, 12, 12, 12, 12, 1, 1, 12, 12, 12, 12, 12, 13, 13, 12, 12, 12, 12, 12, 12, 1, ],
	[1, 13, 12, 12, 12, 12, 12, 12, 12, 12, 12, 12, 12, 1, 1, 12, 13, 13, 12, 12, 12, 12, 12, 12, 12, 12, 12, 12, 1, 1, 12, 12, 12, 12, 12, 12, 12, 12, 12, 12, 12, 12, 13, 1, ],
	[1, 12, 12, 12, 12, 12, 12, 12, 12, 12, 12, 12, 13, 1, 1, 12, 13, 13, 12, 12, 12, 12, 12, 12, 12, 12, 12, 12, 1, 1, 12, 12, 12, 13, 12, 12, 12, 12, 12, 12, 12, 12, 12, 1, ],
]
