Connections;
Exits;ABANDONED SHIP (24.59);ABANDONED SHIP (24.59);ABANDONED SHIP (24.58);ABANDONED SHIP (24.58);ABANDONED SHIP (24.58);ABANDONED SHIP (24.61);ABANDONED SHIP (24.55);ABANDONED SHIP (24.55);
1 1 1 1 1 1 1 1 1 1 1 1 1 
1 1 1 1 1 1 1 1 1 1 1 1 1 
12 1 1 1 1 1 1 1 12 1 1 1 1 
12 12 1 1 1 1 0 1 12 12 1 1 1 
12 12 1 13 1 1 12 1 12 12 1 13 1 
12 12 12 12 12 12 12 12 12 12 12 12 12 
12 12 12 12 12 12 12 12 12 12 12 12 13 
12 12 12 12 12 12 12 12 12 12 12 12 12 
13 12 12 12 1 1 1 1 1 1 1 1 1 
12 12 12 12 1 1 1 1 1 1 1 1 1 
