Connections;
Exits;ABANDONED SHIP (24.54);ABANDONED SHIP (24.54);
1 1 1 1 1 1 1 1 1 
1 1 1 1 1 1 1 1 1 
12 12 12 12 12 12 12 1 1 
13 12 12 12 12 12 12 12 12 
13 12 12 12 12 12 12 12 12 
12 12 12 13 13 12 12 12 12 
12 12 12 13 13 12 12 12 12 
