Connections;
Exits;ABANDONED SHIP (24.65);ABANDONED SHIP (24.65);ABANDONED SHIP (24.65);ABANDONED SHIP (24.65);ABANDONED SHIP (24.65);ABANDONED SHIP (24.65);ABANDONED SHIP (24.65);ABANDONED SHIP (24.65);ABANDONED SHIP (24.65);
1 1 1 1 1 1 1 1 1 1 1 1 1 1 1 1 1 1 1 1 1 0 1 1 1 1 1 1 1 1 1 1 1 1 1 1 1 1 1 1 1 1 1 1 
1 1 1 1 1 1 13 1 1 1 1 1 1 1 1 1 1 1 1 1 1 12 1 1 1 1 1 1 1 1 1 1 1 1 1 1 13 1 1 1 1 1 1 1 
1 1 12 12 12 12 12 12 12 12 12 12 12 1 1 12 12 12 13 13 1 12 13 13 12 12 12 12 1 1 12 12 12 12 12 12 12 12 12 12 13 13 12 1 
1 12 12 12 12 12 12 12 12 12 12 12 13 1 1 13 12 12 13 13 12 1 13 13 12 12 12 12 12 12 12 12 12 13 12 12 12 12 12 12 13 13 12 1 
1 12 12 13 13 12 12 12 12 12 12 12 12 1 1 12 12 12 12 12 12 12 12 12 12 12 12 12 1 1 12 12 12 12 12 12 12 12 12 12 12 12 12 1 
1 13 12 13 13 12 12 12 12 12 12 12 12 1 1 12 12 12 12 12 12 12 12 12 12 12 12 12 1 1 13 12 13 13 12 12 12 12 13 12 12 12 12 1 
1 12 12 12 12 12 12 12 12 12 12 12 12 1 1 12 12 12 12 12 12 12 12 12 12 12 12 12 1 1 12 12 13 13 12 12 12 12 12 12 12 12 13 1 
1 1 1 1 1 1 1 1 1 1 1 1 1 1 1 1 1 1 1 1 1 1 1 1 1 1 1 1 1 1 1 1 1 1 1 1 1 1 1 1 1 1 1 1 
1 1 1 1 1 1 1 1 1 1 1 1 1 1 1 1 1 1 1 1 1 1 1 1 1 1 1 1 1 1 1 1 1 1 1 1 1 1 1 1 1 1 1 1 
1 1 1 1 1 1 1 1 1 1 1 1 1 1 1 1 1 1 1 1 1 1 1 1 1 1 1 1 1 1 1 1 1 1 1 1 1 1 1 1 1 1 1 1 
1 12 12 12 12 12 12 1 12 12 12 12 12 1 1 12 12 12 12 12 12 12 12 12 12 12 12 12 1 1 12 12 12 12 12 12 12 12 12 12 13 13 12 1 
1 12 12 12 12 12 12 12 12 12 13 13 12 1 1 12 12 12 12 12 12 12 12 12 12 13 12 13 1 1 13 12 12 12 12 13 13 12 12 12 13 13 12 1 
1 12 12 12 12 12 12 12 12 12 13 13 12 1 1 12 12 12 12 12 12 12 12 12 12 12 12 12 1 1 12 12 12 12 12 13 13 12 12 12 12 12 12 1 
1 13 12 12 12 12 12 12 12 12 12 12 12 1 1 12 13 13 12 12 12 12 12 12 12 12 12 12 1 1 12 12 12 12 12 12 12 12 12 12 12 12 13 1 
1 12 12 12 12 12 12 12 12 12 12 12 13 1 1 12 13 13 12 12 12 12 12 12 12 12 12 12 1 1 12 12 12 13 12 12 12 12 12 12 12 12 12 1 
