connections=[
		],
events={
	
		'exits':[{'name':'ABANDONED SHIP (24.57)','x':4,'y':7},{'name':'ABANDONED SHIP (24.57)','x':5,'y':7},{'name':'ABANDONED SHIP (24.57)','x':13,'y':7},{'name':'ABANDONED SHIP (24.57)','x':14,'y':7},		],
	
		'NPCs':[
			{'is_trainer':0,'b1':2,'b2':0,'sprite':'31','x':3,'y':4},
			{'is_trainer':0,'b1':1,'b2':0,'sprite':'59','x':13,'y':3},
		],
	
		'signs':[
		],
	
		'triggers':[
		],

},
partial_map=[
	[1, 1, 1, 1, 1, 1, 1, 1, 1, 1, 1, 1, 1, 1, 1, 1, 1, 1, ],
	[1, 1, 1, 1, 1, 1, 1, 1, 1, 1, 1, 1, 1, 1, 1, 1, 1, 1, ],
	[1, 1, 1, 12, 12, 12, 12, 12, 1, 1, 1, 1, 12, 12, 12, 1, 1, 1, ],
	[1, 1, 1, 12, 12, 1, 1, 13, 1, 1, 1, 1, 12, 12, 12, 1, 1, 1, ],
	[1, 12, 12, 12, 12, 1, 1, 12, 12, 12, 12, 12, 12, 12, 12, 12, 12, 1, ],
	[1, 12, 12, 12, 12, 12, 12, 12, 1, 1, 12, 12, 12, 12, 12, 12, 13, 1, ],
	[1, 13, 12, 12, 12, 12, 12, 12, 1, 1, 13, 12, 12, 12, 12, 12, 12, 1, ],
	[1, 12, 12, 12, 12, 12, 12, 1, 1, 1, 12, 12, 12, 12, 12, 12, 12, 1, ],
]
