connections=[
		],
events={
	{
		exits:[ABANDONED SHIP (24.57),ABANDONED SHIP (24.57),ABANDONED SHIP (24.57),		]},
	{
		NPCs:[
			{is_trainer:0,b1:9,b2:0,sprite:17},
			{is_trainer:0,b1:1,b2:0,sprite:59},
		]},
	{
		signs:[
		]},
	{
		triggers:[
		]},

},
[
	[1, 1, 1, 1, 0, 1, 1, 1, 1, 1, 1, 1, 1, 1, 1, 1, 1, 1, 1, 1, 1, 1, 0, 1, 1, 1, 1, ],
	[1, 1, 1, 1, 12, 1, 1, 1, 1, 1, 1, 1, 1, 13, 1, 1, 1, 1, 1, 1, 1, 1, 12, 1, 1, 1, 1, ],
	[1, 1, 1, 12, 12, 12, 1, 1, 1, 1, 1, 1, 12, 12, 12, 12, 12, 1, 1, 1, 1, 12, 12, 12, 1, 1, 1, ],
	[1, 1, 1, 12, 12, 12, 1, 1, 1, 1, 1, 1, 12, 12, 12, 12, 12, 1, 1, 1, 1, 12, 12, 12, 1, 1, 1, ],
	[1, 12, 12, 12, 12, 12, 12, 12, 1, 1, 12, 12, 12, 12, 12, 12, 13, 1, 1, 12, 12, 12, 12, 12, 12, 12, 1, ],
	[1, 12, 1, 1, 12, 12, 12, 13, 1, 1, 12, 4, 4, 4, 4, 4, 12, 1, 1, 12, 12, 12, 12, 12, 12, 12, 1, ],
	[1, 12, 1, 1, 12, 12, 12, 12, 1, 1, 12, 4, 4, 4, 4, 4, 12, 1, 1, 12, 12, 12, 12, 12, 1, 12, 1, ],
	[1, 13, 12, 12, 12, 12, 12, 12, 1, 1, 12, 4, 4, 4, 4, 4, 12, 1, 1, 12, 12, 12, 12, 12, 12, 13, 1, ],
]
