Connections;
Exits;AQUA HIDEOUT (24.24);AQUA HIDEOUT (24.24);AQUA HIDEOUT (24.24);AQUA HIDEOUT (24.25);AQUA HIDEOUT (24.25);AQUA HIDEOUT (24.25);AQUA HIDEOUT (24.25);AQUA HIDEOUT (24.25);AQUA HIDEOUT (24.25);AQUA HIDEOUT (24.24);
1 1 1 1 1 1 1 1 1 1 1 1 1 1 1 1 1 1 1 1 1 1 1 1 1 1 1 1 1 1 12 12 12 1 
1 1 1 1 1 1 1 1 1 1 1 1 12 1 1 1 1 1 12 1 1 1 1 1 1 1 1 1 1 1 1 1 1 1 
1 1 1 1 1 1 1 1 1 12 12 12 12 12 1 12 12 12 12 12 1 1 1 1 12 12 1 1 1 1 12 12 12 1 
1 1 1 12 1 1 1 12 12 12 12 12 12 12 1 12 12 12 12 12 1 1 1 1 12 12 1 1 1 1 12 12 12 1 
1 12 12 12 12 12 1 12 12 12 12 12 12 12 1 12 12 12 12 12 1 1 1 1 12 12 1 1 1 1 12 12 12 1 
1 12 12 12 12 12 1 12 12 12 12 12 12 12 1 12 12 12 12 12 12 1 1 12 12 12 12 1 1 12 12 12 12 1 
1 12 1 1 12 12 1 12 12 12 12 1 1 1 1 12 12 12 12 12 12 12 12 12 12 12 12 12 12 12 12 12 12 1 
1 12 1 1 1 12 1 12 12 12 12 12 12 12 1 12 12 1 1 12 12 12 12 12 12 12 12 12 12 12 12 12 12 1 
1 12 1 1 1 12 1 12 12 12 12 12 12 12 1 12 12 1 1 12 1 1 1 12 12 1 1 1 1 1 12 12 12 1 
1 12 12 12 12 12 1 12 12 12 12 12 12 12 1 12 12 12 12 12 12 1 1 12 12 1 1 12 1 1 12 12 12 1 
1 1 1 1 1 1 1 1 1 1 1 1 1 1 1 12 12 12 12 12 12 12 12 12 12 12 12 12 12 12 12 12 12 1 
1 1 1 1 1 1 1 1 1 1 1 1 1 1 1 12 12 12 12 12 12 12 12 12 12 12 12 12 12 12 12 12 12 1 
1 12 12 12 12 12 12 12 12 12 12 12 12 12 1 12 12 12 12 12 12 12 12 1 12 12 12 12 12 12 12 12 12 1 
1 12 12 12 12 12 12 12 12 12 12 12 12 12 1 12 12 12 12 12 12 12 1 1 12 12 12 12 12 12 12 12 12 1 
1 12 12 12 12 12 12 12 12 12 12 12 12 12 1 12 12 12 12 12 12 1 1 1 1 1 1 1 1 1 1 1 1 1 
1 1 1 1 1 1 1 1 1 1 1 1 1 1 1 12 12 12 12 12 12 1 1 1 1 1 1 1 1 1 1 1 1 1 
1 4 4 4 4 4 4 4 4 4 4 4 4 4 12 1 1 1 1 1 1 1 1 1 12 12 12 12 12 12 12 12 12 1 
1 4 4 4 4 4 4 4 4 4 4 4 4 4 4 4 4 4 4 4 4 4 4 1 12 12 12 12 12 12 12 12 12 1 
1 4 4 4 4 4 4 4 4 4 4 4 4 4 4 4 4 4 4 4 4 4 4 1 12 12 12 12 12 1 1 1 1 1 
1 4 4 4 4 4 4 4 4 4 4 4 4 4 4 4 4 4 4 4 4 4 4 12 12 12 12 12 12 1 1 1 1 1 
1 4 4 4 4 4 4 4 4 4 4 4 4 4 4 4 4 4 4 4 4 4 4 1 12 12 12 12 12 1 1 12 12 1 
1 4 4 4 4 4 4 4 4 4 4 4 4 4 4 4 4 4 4 4 4 4 4 1 12 12 12 12 12 12 12 12 12 1 
1 4 4 4 4 4 4 4 4 4 4 4 4 4 4 4 4 4 4 4 4 4 4 1 1 1 1 1 1 1 1 1 1 1 
1 1 1 1 1 1 1 1 1 1 1 1 1 1 1 1 1 1 1 1 1 1 1 1 1 1 1 1 1 1 1 1 1 1 
