Connections;
Exits;LILYCOVE CITY (0.5);LILYCOVE CITY (0.5);AQUA HIDEOUT (24.24);
1 1 1 1 1 1 1 1 1 1 1 1 1 1 1 1 1 1 1 1 1 1 1 1 1 1 1 1 
1 1 1 1 1 1 1 1 1 1 1 1 1 1 1 1 1 1 1 1 1 1 12 1 1 1 1 1 
1 1 1 1 1 1 1 1 12 12 12 12 12 1 1 12 12 12 12 12 12 12 12 12 12 1 1 1 
1 1 1 1 1 1 12 12 12 12 12 12 12 12 12 12 12 12 12 12 12 12 12 12 12 1 1 1 
1 1 1 1 1 12 12 12 12 12 12 12 12 12 12 12 12 12 12 12 12 12 12 12 12 12 1 1 
1 1 1 1 1 12 12 12 1 1 1 1 1 1 1 1 1 1 1 1 12 12 12 12 12 12 1 1 
1 1 1 1 1 12 12 12 1 12 12 12 12 12 12 12 12 12 12 1 12 12 12 12 12 12 1 1 
1 1 1 1 12 12 12 12 1 12 12 12 12 12 12 12 12 12 12 1 12 12 12 12 12 12 1 1 
1 1 1 12 12 12 12 12 1 1 1 1 1 1 1 1 1 1 1 1 12 12 12 12 12 1 1 1 
1 1 12 12 12 12 12 12 12 12 12 12 12 12 12 12 12 12 12 12 12 12 12 12 12 1 1 1 
1 1 12 12 12 12 12 12 12 12 12 12 12 12 12 12 12 12 12 12 12 12 12 12 12 1 1 1 
1 1 12 12 12 1 1 1 1 1 1 1 1 12 12 1 1 1 1 1 1 1 1 12 12 1 1 1 
1 1 12 12 12 1 1 1 1 1 1 1 1 12 12 1 1 1 1 1 1 1 1 12 12 1 1 1 
1 1 12 12 12 1 1 4 4 4 4 4 4 4 4 4 4 4 4 4 4 1 1 12 12 12 1 1 
1 1 12 12 12 1 1 4 4 4 4 4 4 4 4 4 4 4 4 4 4 1 1 12 12 12 1 1 
1 1 12 12 12 1 1 4 4 4 4 4 4 4 4 4 4 4 4 4 4 1 1 12 12 12 1 1 
1 1 1 1 12 1 1 4 4 4 4 4 4 4 4 4 4 4 4 4 4 1 1 12 12 12 1 1 
1 1 1 1 12 0 16 16 16 16 1 4 4 4 4 4 1 16 16 16 16 16 0 12 12 12 1 1 
1 1 12 12 12 0 16 16 16 16 1 4 4 4 4 4 1 16 16 16 16 16 0 12 12 12 1 1 
1 1 12 12 12 1 1 1 1 1 1 4 4 4 4 4 1 1 1 1 1 1 1 12 1 1 1 1 
1 1 12 12 12 1 1 4 4 4 4 4 4 4 4 4 4 4 4 4 4 1 1 12 1 1 1 1 
1 1 12 12 12 1 1 4 4 4 4 4 4 4 4 4 4 4 4 4 4 1 1 12 12 12 1 1 
1 1 12 12 12 1 1 4 4 4 4 4 4 4 4 4 4 4 4 4 4 1 1 12 12 12 1 1 
1 1 1 1 12 1 1 4 4 4 4 4 4 4 4 4 4 4 4 4 4 1 1 12 12 12 1 1 
1 1 1 1 12 1 1 4 4 4 4 4 4 4 4 4 4 4 4 4 4 1 1 12 1 1 1 1 
1 1 12 12 12 0 16 16 16 16 16 1 4 4 4 1 16 16 16 16 16 16 0 12 1 1 1 1 
1 1 12 12 12 0 16 16 16 16 16 1 4 4 4 1 16 16 16 16 16 16 0 12 12 12 1 1 
1 1 1 1 1 1 1 1 1 1 1 1 4 4 4 1 1 1 1 1 1 1 1 1 1 1 1 1 
1 1 1 1 1 1 1 1 1 1 1 1 1 1 1 1 1 1 1 1 1 1 1 1 1 1 1 1 
1 1 1 1 1 1 1 1 1 1 1 1 1 1 1 1 1 1 1 1 1 1 1 1 1 1 1 1 
