Connections;
Exits;
1 1 1 1 1 1 1 1 1 1 1 1 1 1 1 1 1 1 1 1 1 1 1 1 1 1 1 1 
1 1 1 1 1 1 1 1 1 1 1 1 1 12 1 1 1 1 1 1 1 1 1 1 1 1 1 1 
1 1 1 1 12 12 12 12 12 12 12 12 12 12 12 12 12 12 12 12 12 12 12 12 1 1 1 1 
1 1 12 12 12 12 12 12 12 12 12 12 12 12 12 12 12 12 12 12 12 12 12 12 1 1 1 1 
1 1 1 1 1 12 12 12 1 1 1 1 1 1 1 1 1 1 1 12 12 12 12 12 1 1 1 1 
1 1 1 1 1 12 12 1 1 1 12 12 12 12 12 12 12 1 1 1 12 12 12 12 1 1 1 1 
1 1 1 1 1 12 12 1 1 1 1 1 1 1 1 1 1 1 1 1 12 12 12 12 12 1 1 1 
1 1 1 1 12 12 12 1 1 1 1 1 1 1 1 1 1 1 1 1 12 12 12 12 12 12 1 1 
1 1 1 12 12 12 12 1 1 1 1 1 1 1 1 1 1 1 1 1 12 12 12 12 12 12 1 1 
1 1 12 12 12 12 12 12 12 12 12 12 12 12 12 12 12 12 12 12 12 12 12 12 12 12 1 1 
1 1 12 12 12 12 12 12 12 12 12 12 12 12 12 12 12 12 12 12 12 12 12 12 12 12 1 1 
1 1 1 1 1 1 1 1 1 1 1 1 1 12 12 1 1 1 1 1 1 1 1 1 1 1 1 1 
1 1 1 1 1 1 1 1 1 1 1 1 1 12 12 1 1 1 1 1 1 1 1 1 1 1 1 1 
1 1 12 12 12 12 12 12 12 12 12 12 12 12 12 12 12 12 12 12 12 12 12 12 12 12 1 1 
1 1 12 12 12 12 12 12 12 12 12 12 12 12 12 12 12 12 12 12 12 12 12 12 12 12 1 1 
1 1 1 1 1 1 1 1 1 1 1 1 1 12 12 1 1 1 1 1 1 1 1 1 1 1 1 1 
1 1 1 1 1 1 1 1 1 1 1 1 1 12 12 1 1 1 1 1 1 1 1 1 1 1 1 1 
1 1 12 12 12 12 12 12 12 12 12 12 12 12 12 12 12 12 12 12 12 12 12 12 12 12 1 1 
1 1 12 12 12 12 12 12 12 12 12 12 12 12 12 12 12 12 12 12 12 12 12 12 12 12 1 1 
1 1 12 12 12 1 1 1 1 1 1 1 1 12 12 1 1 1 1 1 1 1 1 12 12 12 1 1 
1 1 1 1 12 1 1 1 1 1 1 1 1 12 12 1 1 1 1 1 1 1 1 12 1 1 1 1 
1 1 1 1 12 1 1 13 12 12 12 1 12 12 12 12 1 0 12 12 13 1 1 12 1 1 1 1 
1 1 12 12 12 1 1 13 13 13 13 1 12 12 12 12 1 1 13 13 13 1 1 12 12 12 1 1 
1 1 12 12 12 1 1 13 13 12 12 12 12 12 12 12 12 12 12 13 13 1 1 12 12 12 1 1 
1 1 1 1 12 1 1 13 13 12 12 12 12 12 12 12 12 12 12 1 1 1 1 12 1 1 1 1 
1 1 1 1 12 1 1 1 1 12 12 12 12 12 12 12 12 12 12 1 1 1 1 12 1 1 1 1 
1 1 12 12 12 1 1 1 1 1 1 1 4 4 4 1 1 1 1 1 1 1 1 12 12 12 1 1 
1 1 1 1 1 1 1 1 1 1 1 1 4 4 4 1 1 1 1 1 1 1 1 1 1 1 1 1 
1 1 1 1 1 1 1 1 1 1 1 1 1 1 1 1 1 1 1 1 1 1 1 1 1 1 1 1 
1 1 1 1 1 1 1 1 1 1 1 1 1 1 1 1 1 1 1 1 1 1 1 1 1 1 1 1 
