connections=[
		],
events={
	{
		exits:[BATTLE FRONTIER (26.4),BATTLE FRONTIER (26.4),		]},
	{
		NPCs:[
			{is_trainer:0,b1:8,b2:0,sprite:85},
		]},
	{
		signs:[
		]},
	{
		triggers:[
		]},

},
[
	[1, 1, 0, 0, 0, 1, 0, 0, 0, ],
	[1, 1, 0, 0, 0, 1, 0, 0, 0, ],
	[13, 13, 0, 0, 0, 0, 0, 1, 1, ],
	[13, 13, 0, 0, 0, 0, 0, 0, 0, ],
	[13, 13, 0, 0, 0, 0, 0, 0, 0, ],
	[13, 13, 0, 0, 0, 0, 0, 0, 0, ],
	[13, 13, 0, 0, 0, 0, 0, 0, 0, ],
	[1, 1, 1, 1, 0, 0, 0, 0, 0, ],
]
