Connections;
Exits;BATTLE FRONTIER (26.14);BATTLE FRONTIER (26.14);BATTLE FRONTIER (26.8);
1 1 1 1 1 1 1 1 1 1 1 1 1 1 1 1 1 1 1 1 1 1 1 1 1 
1 1 1 1 1 1 1 1 1 1 1 1 1 1 1 1 1 1 1 1 1 1 1 1 1 
12 0 0 0 1 0 0 0 1 0 0 0 1 0 0 0 1 0 0 0 1 12 12 12 12 
12 12 12 12 1 0 12 12 1 0 12 12 1 0 12 12 1 0 12 12 1 12 12 12 12 
12 12 12 12 1 0 12 0 1 0 12 0 1 0 12 0 1 0 12 0 1 12 12 12 12 
12 12 12 12 1 1 12 1 1 1 12 1 1 1 12 1 1 1 12 1 1 12 12 12 12 
12 12 12 12 12 0 0 0 12 0 0 0 12 0 0 0 12 0 0 0 12 12 12 12 12 
12 12 12 12 12 12 12 12 12 12 12 12 12 12 12 12 12 12 12 12 12 12 12 12 12 
12 12 12 12 12 12 12 12 12 12 12 12 12 12 12 12 12 12 12 12 12 12 12 12 12 
1 1 12 12 12 12 12 12 12 12 12 12 12 12 12 12 12 12 12 12 12 12 12 1 1 
