Connections;left:BATTLE FRONTIER (26.4);
Exits;BATTLE FRONTIER (26.5);BATTLE FRONTIER (26.28);BATTLE FRONTIER (26.22);BATTLE FRONTIER (26.25);BATTLE FRONTIER (26.40);BATTLE FRONTIER (26.41);BATTLE FRONTIER (26.42);BATTLE FRONTIER (26.47);BATTLE FRONTIER (26.48);BATTLE FRONTIER (26.44);BATTLE FRONTIER (26.51);BATTLE FRONTIER (26.52);BATTLE FRONTIER (26.53);ARTISAN CAVE (24.100);
0 0 0 0 0 0 0 0 1 1 1 1 1 1 1 1 1 1 1 1 1 1 1 1 1 1 0 0 1 1 0 0 1 1 0 0 1 1 1 1 1 1 1 1 1 1 1 1 1 1 1 1 1 1 1 1 1 1 1 1 1 1 1 1 1 1 1 1 0 0 1 1 
0 0 0 0 0 0 0 0 1 1 1 1 1 1 1 1 1 1 1 1 1 1 1 1 1 0 0 0 0 0 0 0 0 0 0 0 0 0 1 1 0 0 1 1 0 0 1 1 0 0 1 1 0 0 1 1 0 0 1 1 0 0 1 1 0 0 1 1 0 0 1 1 
0 0 0 0 0 0 0 0 1 1 1 1 1 1 1 1 1 1 1 1 1 1 1 1 1 13 13 13 13 13 13 13 13 13 13 13 0 1 0 0 0 0 0 0 0 0 0 0 0 0 0 0 0 0 0 0 0 0 0 0 0 0 0 0 0 0 0 0 1 1 0 0 
13 13 13 13 13 13 13 13 1 1 1 1 1 1 1 1 1 1 1 1 1 1 1 1 1 13 13 13 13 13 13 13 13 13 13 13 0 1 1 0 0 0 0 0 0 0 0 0 0 0 0 0 0 0 0 0 0 0 0 0 0 0 0 0 0 0 0 0 1 1 0 0 
13 13 13 13 13 13 13 13 1 1 1 1 1 1 1 1 1 1 1 1 1 1 1 1 1 0 1 0 0 0 0 0 0 0 0 0 1 1 1 1 1 1 1 1 1 1 1 1 1 1 1 1 1 1 1 1 1 1 1 1 1 1 1 1 1 1 1 1 0 0 0 0 
12 12 12 12 12 12 12 1 1 1 1 1 1 1 1 1 1 1 1 1 1 1 1 1 1 0 1 1 1 1 1 1 1 1 1 1 1 1 1 1 12 12 12 12 12 12 12 12 12 12 12 12 12 12 12 12 12 12 12 12 12 12 12 12 12 12 1 1 1 0 0 0 
12 12 12 1 1 1 1 1 1 1 1 1 1 1 1 1 1 1 1 1 1 1 1 1 1 0 13 1 1 1 1 1 1 1 1 1 1 1 1 1 12 12 12 12 12 12 12 12 12 12 12 12 12 12 12 12 1 1 1 1 1 12 12 12 12 12 1 1 1 1 0 0 
12 12 12 1 1 1 1 1 1 1 1 1 1 1 1 1 1 1 1 1 1 1 1 1 1 0 1 13 0 1 1 1 1 1 1 1 1 1 1 1 1 12 12 12 12 1 1 12 12 12 12 1 12 12 1 1 1 1 1 1 1 1 1 12 12 1 1 1 1 1 1 0 
12 12 12 12 1 1 1 1 1 1 1 1 1 1 1 1 1 1 1 1 1 1 1 1 1 1 1 1 12 12 1 1 1 1 1 1 1 1 1 1 1 0 0 0 0 1 1 1 12 12 12 1 1 1 1 1 1 1 1 1 1 1 1 1 1 1 1 1 1 1 1 0 
12 12 12 12 12 12 12 1 1 1 1 1 1 1 1 1 1 1 1 1 1 1 1 1 1 1 1 1 1 1 1 1 1 1 1 1 1 12 12 12 12 12 12 12 12 1 5 1 12 12 12 1 1 1 1 1 1 1 1 1 1 1 1 1 1 1 1 1 1 1 1 0 
12 12 12 12 12 12 12 1 1 1 1 1 1 1 1 1 1 1 1 1 1 1 1 1 1 1 1 1 12 12 12 1 1 1 1 1 1 1 1 12 12 12 12 12 12 1 5 1 12 12 12 1 1 1 1 1 1 1 1 1 1 1 1 1 1 1 1 1 1 1 1 0 
12 12 12 12 12 12 12 1 1 1 1 1 1 1 1 1 1 1 1 1 1 1 1 1 1 1 1 1 12 12 1 1 1 1 1 13 1 1 1 12 12 12 12 12 12 1 5 1 12 12 12 1 1 1 1 1 1 1 1 1 1 1 1 1 1 1 1 1 1 1 1 0 
12 12 12 12 12 12 12 1 1 1 1 1 1 1 1 1 1 1 1 1 1 1 1 1 1 1 1 1 12 12 1 1 1 1 1 12 1 1 1 12 12 12 12 12 12 1 5 1 12 12 12 1 1 1 1 1 1 1 1 1 1 1 1 1 1 1 1 1 1 1 1 0 
12 1 12 12 12 12 12 1 1 1 1 1 1 1 1 1 1 1 1 1 1 1 1 1 1 1 1 1 12 12 1 1 1 12 12 12 12 12 12 12 12 12 12 12 12 1 5 1 12 12 12 1 1 1 1 1 1 1 1 1 1 1 1 1 1 1 1 1 1 1 1 0 
12 1 1 12 12 12 12 1 1 1 1 1 1 12 1 1 1 1 1 12 1 1 1 1 1 1 1 1 12 12 1 12 12 12 12 12 12 12 12 12 12 12 12 12 12 1 5 1 12 12 12 1 1 1 1 1 1 1 0 1 1 1 1 1 1 1 1 1 1 1 1 0 
1 1 1 1 12 12 12 1 12 12 12 12 12 12 12 12 12 12 12 12 12 12 12 12 12 1 1 1 12 1 12 12 12 12 12 12 12 12 12 12 12 12 12 12 12 1 5 1 12 12 12 1 12 12 12 12 12 12 12 12 12 12 1 12 12 1 1 1 1 1 1 0 
1 1 1 1 12 12 12 1 1 1 12 12 12 12 12 12 12 12 12 12 12 12 1 1 1 1 1 1 12 12 12 12 12 12 12 12 12 12 12 12 12 12 12 12 12 1 5 1 12 12 12 12 12 12 12 12 1 1 12 1 1 12 12 12 12 12 1 1 1 1 1 0 
1 1 1 1 12 12 12 12 12 12 1 12 12 1 12 12 12 12 12 12 12 12 1 1 1 1 13 1 12 12 12 12 12 12 12 12 12 12 12 12 12 12 12 12 12 1 5 1 12 12 12 12 12 12 12 12 1 1 12 1 1 12 12 12 12 12 1 1 1 1 1 0 
1 1 1 1 12 12 12 12 12 12 12 12 12 12 12 12 12 12 12 12 12 1 1 1 1 1 1 0 12 12 12 12 12 12 12 12 12 12 12 12 12 12 12 12 12 1 5 1 1 1 1 1 1 12 12 12 12 12 12 12 12 12 12 12 12 12 1 1 1 1 1 0 
1 1 1 1 12 12 12 12 12 12 12 12 12 12 12 12 12 12 12 12 1 1 1 1 1 1 12 12 12 1 5 5 5 5 5 5 5 5 5 5 5 5 5 5 5 1 1 1 1 1 1 1 1 1 12 12 12 12 12 12 12 12 12 1 12 12 1 1 1 1 1 0 
1 1 1 1 1 1 1 12 12 12 12 12 12 12 12 12 12 12 12 12 1 1 1 1 1 12 12 12 12 13 1 1 1 1 1 1 1 1 1 1 1 1 1 1 1 1 1 1 1 1 1 1 5 1 12 12 1 1 12 1 1 12 12 1 12 12 1 1 1 1 1 0 
1 1 1 1 1 1 1 1 12 12 12 12 12 12 12 12 12 12 12 12 1 1 1 1 12 12 12 12 12 1 13 1 1 1 1 1 1 1 1 1 1 1 1 1 1 1 1 1 1 1 1 5 5 1 12 12 1 1 12 1 1 12 12 1 12 12 1 1 1 1 1 0 
1 1 1 1 1 1 1 1 1 1 1 1 1 12 12 12 12 12 12 12 1 1 1 1 12 12 12 12 1 1 1 4 4 4 4 4 4 4 4 4 4 4 4 4 4 4 4 4 4 4 5 5 5 1 12 12 12 12 12 12 12 12 12 1 12 12 1 1 1 1 1 0 
1 0 1 1 1 1 1 1 1 1 1 1 1 1 0 0 0 0 0 0 1 1 1 1 12 12 12 13 1 13 1 4 4 4 5 5 5 5 5 5 5 5 5 5 4 4 4 4 4 4 5 5 5 1 12 12 12 12 12 12 12 12 12 1 12 12 1 1 1 1 1 0 
1 1 1 1 1 1 1 1 1 1 1 1 1 1 0 0 0 0 0 0 1 1 1 1 12 12 12 1 13 1 4 4 1 1 1 13 13 1 1 1 1 1 13 13 1 1 1 4 4 4 5 5 5 1 12 12 1 1 12 1 1 12 12 12 12 12 1 1 1 1 1 0 
1 1 1 1 1 0 1 12 12 1 1 1 12 12 12 12 12 12 12 12 12 12 12 12 12 12 12 1 1 4 4 1 1 13 12 12 12 12 12 12 12 12 12 12 12 13 1 1 4 4 5 5 5 1 12 12 1 1 12 1 1 12 12 12 12 12 1 1 1 1 1 0 
1 1 1 1 1 1 1 1 1 1 1 1 1 1 12 12 12 12 12 12 12 12 12 12 12 12 12 1 1 4 0 1 1 13 12 1 1 1 1 1 1 1 1 1 12 13 1 1 0 4 5 5 5 1 12 12 12 12 12 12 12 12 1 1 1 1 1 1 1 1 1 0 
1 1 1 1 1 1 1 1 1 1 1 1 1 1 12 12 12 12 12 12 12 12 12 12 12 12 12 1 1 4 0 1 1 13 12 1 1 1 1 1 1 1 1 1 12 13 1 1 0 4 5 5 1 1 0 0 0 0 0 0 0 0 1 1 1 1 1 1 1 1 1 0 
1 1 1 1 1 12 12 1 1 1 1 1 1 1 12 12 12 12 12 12 12 12 12 12 12 12 12 1 1 4 0 1 1 13 12 1 1 1 1 1 1 1 1 1 12 13 1 1 0 4 5 1 1 1 12 12 12 12 12 12 12 12 12 12 12 12 12 1 1 1 1 0 
1 1 1 1 1 12 12 1 12 12 12 12 12 12 12 12 12 12 12 12 12 12 12 12 12 12 12 1 1 4 0 1 1 13 12 1 1 1 1 1 1 1 1 1 12 13 1 1 0 4 1 1 5 1 12 12 12 12 12 12 12 12 1 1 1 1 1 1 1 1 1 0 
4 4 0 1 1 12 12 12 12 12 12 12 12 12 12 12 12 12 12 12 12 12 12 12 12 1 1 1 1 4 0 1 1 1 12 12 12 12 12 12 12 12 12 12 12 1 1 1 0 0 4 5 5 1 12 12 12 12 12 12 12 12 1 1 1 1 1 1 1 1 1 0 
4 4 4 1 1 12 12 12 12 12 12 12 12 12 12 12 12 12 12 12 12 12 12 12 12 1 13 1 1 4 0 1 1 1 1 1 1 1 12 12 12 1 1 1 1 1 1 1 0 0 4 5 5 1 12 12 12 12 12 12 12 12 1 1 1 1 1 1 1 1 1 0 
4 4 4 1 1 12 12 12 12 12 12 12 12 12 12 12 12 12 12 12 12 12 12 12 1 1 1 4 4 4 0 1 1 1 1 1 0 0 0 0 0 0 0 1 1 1 1 1 0 0 4 5 5 1 12 12 12 12 12 12 12 12 1 12 12 12 12 1 1 1 1 0 
4 4 4 1 1 12 12 12 12 12 12 12 12 12 12 12 12 12 12 12 12 12 12 12 1 13 1 4 4 4 0 1 1 1 1 1 1 1 1 0 1 1 1 1 1 1 1 1 0 0 4 5 5 1 12 12 12 12 12 12 12 12 1 12 12 12 12 1 1 1 1 0 
4 4 4 1 1 1 1 1 1 1 1 1 0 0 0 1 1 1 1 1 0 0 0 1 1 1 4 4 4 4 0 1 1 1 1 12 1 0 12 12 12 12 12 12 1 1 1 1 0 0 4 5 5 1 12 12 12 12 12 12 12 12 12 12 12 12 12 1 1 1 1 0 
4 4 4 1 1 1 1 1 1 1 1 1 0 0 0 1 1 1 1 1 0 0 0 1 1 13 4 4 4 4 0 1 1 1 12 1 12 0 12 12 12 12 12 1 1 1 1 1 0 0 4 5 5 1 12 12 12 12 12 12 12 12 12 12 12 12 12 1 1 1 1 0 
4 4 4 4 4 4 4 4 4 4 4 1 0 0 0 1 1 1 1 1 0 0 0 1 0 4 4 4 4 4 0 1 1 12 1 1 12 12 12 12 12 12 12 1 12 1 1 1 0 0 4 5 5 1 12 12 12 12 12 12 12 12 1 1 12 12 12 1 1 1 1 0 
4 4 4 4 4 4 4 4 4 4 4 1 0 0 0 1 1 1 1 1 0 0 0 1 0 4 4 4 4 4 0 0 1 1 1 1 12 12 12 12 12 12 12 1 1 12 1 0 0 0 4 5 5 1 12 12 12 12 12 12 12 1 1 1 1 1 1 1 1 1 1 0 
4 4 4 4 4 4 4 4 4 4 4 1 0 0 0 1 1 1 1 1 0 0 0 1 0 4 4 4 4 4 4 0 1 1 1 1 12 12 12 12 12 12 12 1 1 1 1 0 0 0 4 5 5 1 12 12 12 12 12 12 1 1 1 1 1 1 1 1 1 1 1 0 
1 1 1 1 1 1 1 1 1 1 1 0 0 0 0 1 1 1 1 1 0 0 0 0 1 1 1 1 1 1 1 1 1 1 1 12 12 12 12 12 12 12 12 12 1 1 1 0 0 0 4 5 5 1 12 12 12 12 12 12 1 1 1 1 1 1 1 1 1 1 1 0 
12 12 12 12 12 12 12 12 12 12 12 12 12 12 12 12 12 12 12 12 12 12 12 12 12 12 12 12 12 12 12 12 12 1 1 1 1 1 12 12 12 1 1 1 1 1 1 1 1 1 1 1 1 12 12 12 12 12 12 12 1 1 1 1 1 1 1 1 1 0 1 0 
12 12 12 12 12 12 12 12 12 12 12 12 12 12 12 12 12 12 12 12 12 12 12 12 12 12 12 12 12 12 12 12 12 12 0 12 12 12 12 12 12 12 12 12 12 12 12 12 12 12 12 12 12 12 12 12 12 12 12 12 1 1 1 1 1 1 1 1 1 1 1 0 
12 12 12 1 1 1 12 12 12 12 12 12 12 12 12 12 12 12 12 12 12 12 12 12 12 12 12 12 12 12 12 12 12 12 0 0 0 12 12 12 12 12 12 12 12 12 12 12 12 12 12 12 12 12 12 12 12 12 12 12 1 1 1 1 1 1 1 1 1 1 1 0 
0 12 1 1 1 1 1 12 12 12 12 1 1 1 12 1 12 12 1 1 1 1 1 1 1 1 1 12 12 12 12 12 12 12 0 12 12 12 12 12 12 12 12 12 12 12 12 12 12 12 12 12 12 12 12 12 12 12 12 12 1 1 1 1 1 13 0 0 0 0 0 0 
0 12 1 1 1 1 12 12 12 12 12 1 1 1 1 1 12 12 1 1 1 1 1 1 1 1 1 12 12 12 12 12 12 12 0 12 12 12 12 12 12 12 12 12 12 12 12 12 12 12 12 12 12 12 12 12 12 12 12 12 1 1 1 1 1 13 0 1 1 1 1 0 
0 12 12 12 12 12 12 12 12 12 12 1 1 1 1 1 12 12 1 1 1 1 1 1 1 1 1 12 12 12 12 12 12 12 12 1 1 1 1 1 1 1 1 12 12 12 12 12 1 1 1 1 1 1 1 1 12 12 12 12 1 1 1 1 1 13 0 1 1 1 1 0 
0 12 12 12 12 12 12 12 12 12 12 12 12 12 12 12 12 12 12 12 12 12 12 12 12 12 12 12 12 12 12 12 12 12 1 4 4 4 4 4 4 4 1 12 12 12 12 12 1 4 4 4 4 4 4 4 1 12 12 12 1 1 1 1 1 13 0 1 1 1 1 0 
0 12 12 12 12 12 12 12 12 12 12 12 12 12 12 12 12 12 12 12 12 12 12 12 12 12 12 12 12 12 12 12 12 12 1 4 4 4 4 4 4 4 1 1 12 12 12 1 1 4 4 4 4 4 4 4 1 12 12 1 1 1 1 1 1 1 0 1 1 1 1 0 
0 12 12 12 12 12 12 12 12 12 12 12 12 12 12 12 12 12 12 12 12 12 12 12 12 12 12 12 12 12 12 12 12 1 1 4 4 4 12 12 12 12 1 12 12 12 12 12 1 12 12 12 4 4 4 4 1 12 12 1 1 1 12 12 1 1 0 1 1 1 1 0 
0 1 1 1 1 1 1 12 12 12 1 1 1 1 1 1 12 12 1 1 1 1 1 1 1 1 1 12 12 12 12 12 1 1 1 4 4 12 1 1 1 1 12 12 12 12 12 12 12 1 1 1 12 12 4 4 1 12 1 1 1 12 1 1 1 1 0 1 1 4 4 0 
0 12 1 1 1 1 12 12 12 12 1 1 1 1 1 1 12 12 1 1 1 1 1 1 1 1 1 12 12 12 12 12 1 4 4 4 4 1 12 12 12 12 12 12 12 12 12 12 12 12 12 12 1 1 4 4 4 12 1 1 1 1 1 1 1 1 0 1 1 1 1 0 
0 1 1 1 1 1 1 12 12 12 12 1 1 1 1 1 12 12 12 12 12 1 1 1 1 1 1 12 12 12 12 1 1 4 4 4 4 1 12 12 1 1 1 1 1 1 1 1 1 1 1 12 1 1 4 4 4 12 1 1 12 1 1 1 0 0 1 1 1 1 1 0 
0 12 12 12 12 12 12 12 12 12 12 12 12 12 12 12 12 12 12 12 12 12 12 12 12 12 12 12 12 12 12 1 1 4 1 1 4 1 12 12 1 1 1 1 1 1 1 1 1 1 1 12 12 1 4 4 4 12 1 1 1 1 1 1 1 1 1 1 1 4 4 0 
0 12 12 12 12 12 12 12 12 12 12 12 12 12 12 12 12 12 12 12 12 12 12 12 12 12 12 12 12 12 1 1 1 4 1 1 4 1 1 12 1 1 1 1 1 1 1 1 1 1 1 12 12 1 4 4 4 12 12 12 12 12 12 12 1 1 1 1 1 1 1 0 
12 12 12 12 12 12 12 12 12 12 12 12 12 12 12 12 12 12 12 12 12 12 12 12 12 12 12 12 12 12 1 1 1 4 4 4 4 1 1 12 1 1 1 1 1 1 1 1 1 1 1 12 12 1 1 1 4 12 1 1 1 1 1 1 1 5 1 1 1 1 1 0 
1 1 1 1 1 1 1 1 1 1 1 1 1 1 1 12 12 12 12 12 12 12 12 12 12 12 12 12 12 12 12 1 1 12 12 12 12 1 1 12 12 12 12 12 1 1 1 12 12 12 12 12 12 1 1 1 4 12 12 12 1 1 1 1 1 1 5 1 1 4 4 0 
1 1 1 1 1 1 1 1 1 1 1 13 0 0 0 1 12 12 12 12 12 12 12 12 12 12 12 12 12 12 12 12 1 1 1 1 1 1 12 12 12 12 12 1 1 0 1 12 12 12 12 12 1 1 4 4 4 12 12 12 12 12 1 1 1 1 1 5 1 1 1 0 
1 1 1 1 1 1 1 1 1 0 0 1 0 0 1 1 12 12 12 12 12 12 12 12 12 12 12 12 12 12 12 12 12 12 12 12 12 12 12 12 12 12 12 12 12 12 12 12 1 1 1 1 4 4 4 4 4 12 1 1 1 1 1 1 1 1 1 5 1 1 1 0 
1 1 1 1 1 1 1 0 1 0 1 1 0 0 1 1 12 12 1 1 1 1 1 1 1 1 1 12 12 12 12 12 12 12 12 12 12 12 12 12 12 12 12 12 12 12 12 12 4 4 4 4 4 4 4 4 4 12 1 1 1 1 1 1 1 1 1 5 1 4 4 0 
4 4 4 4 4 4 1 1 1 0 1 1 0 0 1 1 12 12 12 12 12 12 12 12 12 12 12 12 12 12 12 12 12 12 4 4 4 4 4 4 4 4 4 4 4 4 4 4 4 4 4 4 1 1 12 12 12 12 1 1 1 1 1 1 1 12 1 5 1 1 1 0 
4 4 4 1 1 4 1 1 1 0 1 1 0 0 1 1 12 12 12 12 12 12 12 12 12 12 12 12 12 12 12 12 1 1 4 4 4 4 4 4 4 4 4 4 4 4 4 4 4 4 1 1 1 1 1 1 1 12 1 1 1 1 1 1 12 12 1 1 1 1 1 0 
4 4 4 1 1 4 1 1 1 0 1 1 0 0 1 1 1 1 1 1 1 1 1 1 1 1 1 1 1 1 1 1 1 1 1 1 1 1 1 1 1 1 1 1 1 1 1 1 1 1 1 1 4 4 1 1 12 12 1 1 1 1 1 12 12 12 1 1 1 4 4 0 
4 4 4 4 4 4 1 1 1 0 1 1 1 1 1 1 1 1 1 1 1 1 1 1 1 1 1 1 1 1 1 1 1 1 1 1 1 1 1 1 1 1 1 1 1 1 1 1 1 1 4 4 4 4 12 12 12 1 1 1 1 1 12 12 12 12 1 5 1 1 1 0 
4 4 4 4 4 4 1 1 1 1 1 1 1 1 1 1 1 1 1 1 1 1 1 1 1 1 1 1 1 1 1 1 1 1 4 4 4 4 4 4 4 4 4 4 4 4 4 4 4 4 4 4 4 4 1 1 1 1 1 1 1 1 1 1 1 1 1 5 4 1 1 0 
4 4 4 4 4 4 1 1 1 1 1 1 1 1 1 1 1 1 1 1 1 1 1 1 1 1 1 1 1 1 1 1 1 1 4 4 4 4 4 4 4 4 4 4 4 4 4 4 4 4 4 4 4 4 1 1 1 1 1 1 1 1 1 1 1 4 4 0 4 4 4 0 
4 4 4 4 4 4 4 4 4 4 4 4 4 4 4 4 4 4 4 4 4 4 4 4 4 4 4 4 4 4 1 1 1 1 4 4 4 4 4 4 4 4 4 4 4 4 4 4 4 4 4 4 4 4 1 1 1 1 1 1 1 1 1 1 1 4 4 4 4 4 4 0 
4 4 4 4 4 4 4 4 4 4 4 4 4 4 4 4 4 4 4 4 4 4 4 4 4 4 4 4 4 4 1 1 1 1 4 4 4 4 4 4 4 4 4 4 4 4 4 4 4 4 4 4 4 4 1 1 1 1 1 1 1 1 1 4 4 1 1 4 4 1 1 0 
4 4 4 4 4 4 4 4 4 4 4 4 4 4 4 4 4 4 4 4 4 4 4 4 4 4 4 4 4 4 4 4 4 4 4 4 4 4 4 4 4 4 4 4 4 4 4 4 4 4 4 4 4 4 4 4 4 4 1 1 4 4 0 4 4 1 1 4 4 1 1 0 
4 4 4 4 4 4 4 4 4 4 4 4 4 4 4 4 4 4 4 4 4 4 4 4 4 4 4 4 4 4 4 4 4 4 4 4 4 4 4 4 4 4 4 4 4 4 4 4 4 4 4 4 4 4 4 4 4 4 1 1 0 1 1 0 0 0 0 0 0 0 0 0 
4 1 1 4 4 1 1 4 4 1 1 4 4 1 1 4 4 1 1 4 4 1 1 4 4 1 1 4 4 1 1 4 4 1 1 4 4 1 1 4 4 1 1 4 4 1 1 4 4 1 1 4 4 1 1 4 4 1 1 0 0 1 1 0 0 0 0 1 1 0 0 0 
1 1 1 1 1 1 1 1 1 1 1 1 1 1 1 1 1 1 1 1 1 1 1 1 1 1 1 1 1 1 1 1 1 1 1 1 1 1 1 1 1 1 1 1 1 1 1 1 1 1 1 1 1 1 1 1 1 1 1 0 0 0 0 0 1 1 0 1 1 0 0 0 
1 0 0 1 1 0 0 1 1 0 0 1 1 0 0 1 1 0 0 1 1 0 0 1 1 0 0 1 1 0 0 1 1 0 0 1 1 0 0 1 1 0 0 1 1 0 0 1 1 0 0 1 1 0 0 1 1 0 0 0 0 0 0 0 1 1 0 0 0 0 0 0 
