connections=[
		],
events={
	{
		exits:[		]},
	{
		NPCs:[
			{is_trainer:0,b1:8,b2:0,sprite:44},
		]},
	{
		signs:[
		]},
	{
		triggers:[
		]},

},
[
	[1, 1, 1, 1, 1, 1, 61, 61, 61, 61, 61, 61, 1, 1, 1, 1, 1, 1, ],
	[1, 1, 1, 1, 1, 1, 61, 61, 61, 61, 61, 61, 1, 1, 1, 1, 1, 1, ],
	[13, 13, 13, 13, 13, 13, 61, 61, 61, 61, 61, 61, 13, 13, 13, 13, 13, 13, ],
	[0, 0, 0, 0, 0, 0, 61, 61, 61, 61, 61, 61, 0, 0, 0, 0, 0, 0, ],
	[0, 0, 0, 0, 0, 0, 61, 61, 61, 61, 61, 61, 0, 0, 0, 0, 0, 0, ],
	[0, 0, 0, 61, 61, 61, 61, 61, 61, 61, 61, 61, 61, 61, 61, 0, 0, 0, ],
	[0, 0, 0, 61, 61, 61, 61, 61, 61, 61, 61, 61, 61, 61, 61, 0, 0, 0, ],
	[0, 0, 0, 61, 61, 61, 61, 61, 61, 61, 61, 61, 61, 61, 61, 0, 0, 0, ],
	[0, 0, 0, 1, 1, 1, 1, 1, 1, 1, 1, 1, 1, 1, 1, 0, 0, 0, ],
	[0, 0, 0, 1, 1, 1, 1, 1, 1, 1, 1, 1, 1, 1, 1, 0, 0, 0, ],
	[0, 0, 0, 1, 1, 1, 1, 1, 1, 1, 1, 1, 1, 1, 1, 0, 0, 0, ],
	[0, 0, 0, 13, 13, 13, 13, 13, 13, 13, 13, 13, 13, 13, 13, 0, 0, 0, ],
	[0, 0, 12, 12, 12, 12, 12, 12, 12, 12, 12, 12, 12, 12, 12, 12, 12, 12, ],
	[0, 0, 12, 12, 12, 12, 12, 12, 0, 0, 0, 12, 12, 12, 12, 12, 12, 0, ],
]
