connections=[
		],
events={
	{
		exits:[BATTLE FRONTIER (26.4),BATTLE FRONTIER (26.4),		]},
	{
		NPCs:[
			{is_trainer:0,b1:8,b2:0,sprite:46},
			{is_trainer:0,b1:2,b2:0,sprite:16},
			{is_trainer:0,b1:8,b2:0,sprite:31},
			{is_trainer:0,b1:10,b2:0,sprite:32},
			{is_trainer:0,b1:1,b2:0,sprite:17},
			{is_trainer:0,b1:8,b2:0,sprite:46},
		]},
	{
		signs:[
			{x:2,y:7},
			{x:11,y:7},
			{x:9,y:4},
		]},
	{
		triggers:[
		]},

},
[
	[1, 1, 1, 1, 1, 1, 1, 1, 1, 1, 1, 1, 1, 1, 1, 1, 1, 1, 1, ],
	[1, 1, 1, 1, 1, 1, 1, 1, 1, 1, 1, 1, 1, 1, 1, 1, 1, 1, 1, ],
	[1, 1, 1, 1, 1, 1, 1, 0, 0, 0, 0, 0, 1, 1, 1, 1, 1, 1, 1, ],
	[1, 1, 1, 1, 1, 1, 1, 0, 0, 0, 0, 0, 1, 1, 1, 1, 1, 1, 1, ],
	[1, 1, 1, 1, 0, 1, 1, 1, 1, 1, 1, 1, 1, 1, 0, 1, 1, 1, 1, ],
	[1, 1, 1, 0, 0, 0, 0, 1, 12, 12, 12, 1, 0, 0, 0, 0, 1, 1, 1, ],
	[12, 12, 1, 1, 0, 0, 1, 1, 12, 12, 12, 1, 1, 0, 0, 0, 1, 12, 12, ],
	[12, 12, 1, 1, 0, 1, 1, 1, 1, 0, 1, 1, 1, 1, 0, 1, 1, 12, 12, ],
	[12, 12, 12, 0, 0, 0, 12, 12, 12, 12, 12, 12, 12, 0, 0, 0, 12, 12, 12, ],
	[12, 12, 12, 12, 12, 12, 12, 12, 12, 12, 12, 12, 12, 12, 12, 12, 12, 12, 0, ],
	[12, 12, 12, 12, 12, 12, 12, 12, 12, 12, 12, 12, 12, 0, 12, 12, 12, 12, 0, ],
	[12, 12, 12, 12, 12, 12, 12, 12, 12, 0, 0, 0, 0, 0, 0, 1, 0, 1, 0, ],
]
