connections=[
		],
events={
	
		'exits':[{'name':'BATTLE FRONTIER (26.14)','x':7,'y':17},		],
	
		'NPCs':[
			{'is_trainer':0,'b1':8,'b2':0,'sprite':'55','x':7,'y':12},
			{'is_trainer':0,'b1':9,'b2':0,'sprite':'40','x':14,'y':13},
			{'is_trainer':0,'b1':2,'b2':0,'sprite':'24','x':2,'y':15},
			{'is_trainer':0,'b1':2,'b2':0,'sprite':'17','x':12,'y':16},
		],
	
		'signs':[
			{'x':5,'y':12},
			{'x':1,'y':12},
		],
	
		'triggers':[
		],

},
partial_map=[
	[17, 17, 17, 17, 17, 17, 17, 17, 17, 17, 17, 17, 17, 17, 17, ],
	[17, 17, 17, 17, 17, 17, 17, 17, 17, 17, 17, 17, 17, 17, 17, ],
	[17, 17, 17, 17, 17, 17, 17, 17, 17, 17, 17, 17, 17, 17, 17, ],
	[17, 17, 17, 0, 17, 17, 17, 17, 17, 0, 17, 17, 17, 17, 17, ],
	[17, 17, 17, 0, 17, 17, 17, 16, 17, 0, 17, 17, 17, 17, 17, ],
	[16, 16, 17, 16, 17, 16, 16, 16, 16, 16, 17, 16, 17, 16, 16, ],
	[16, 16, 16, 16, 16, 16, 16, 16, 16, 16, 16, 16, 16, 16, 16, ],
	[16, 16, 16, 16, 16, 16, 16, 16, 16, 16, 16, 16, 16, 16, 16, ],
	[16, 16, 16, 17, 17, 17, 17, 16, 17, 17, 17, 17, 16, 16, 16, ],
	[16, 16, 16, 17, 17, 17, 17, 16, 17, 17, 17, 17, 16, 16, 16, ],
	[0, 0, 0, 17, 17, 17, 17, 16, 17, 17, 17, 17, 17, 17, 17, ],
	[1, 1, 0, 17, 17, 1, 17, 16, 17, 17, 17, 17, 17, 1, 17, ],
	[1, 1, 1, 17, 17, 1, 17, 16, 17, 17, 17, 17, 17, 1, 17, ],
	[0, 0, 0, 16, 16, 0, 16, 16, 16, 16, 16, 16, 16, 16, 16, ],
	[16, 16, 16, 16, 16, 16, 16, 16, 16, 16, 16, 16, 16, 16, 16, ],
	[16, 16, 16, 16, 16, 16, 16, 16, 16, 16, 16, 16, 16, 16, 16, ],
	[16, 16, 16, 16, 16, 16, 16, 16, 16, 16, 16, 16, 16, 16, 16, ],
	[16, 16, 16, 16, 16, 16, 16, 16, 16, 16, 16, 16, 16, 16, 16, ],
]
