Connections;
Exits;BATTLE FRONTIER (26.4);BATTLE FRONTIER (26.4);
1 1 1 1 1 1 1 1 1 
1 1 1 1 0 1 1 1 1 
0 0 0 0 0 0 0 0 0 
1 1 1 0 0 0 1 1 1 
0 1 0 0 0 0 0 1 0 
1 1 1 0 0 0 1 1 1 
0 0 0 0 0 0 0 0 0 
0 0 0 0 0 0 1 1 1 
0 1 1 0 0 0 0 0 0 
0 0 0 0 0 0 0 0 0 
1 1 1 0 0 0 1 1 1 
0 1 0 0 0 0 0 1 0 
1 1 1 0 0 0 1 1 1 
0 0 0 0 0 0 0 0 0 
