connections=[
		],
events={
	{
		exits:[BATTLE FRONTIER (26.14),		]},
	{
		NPCs:[
			{is_trainer:0,b1:8,b2:0,sprite:55},
			{is_trainer:0,b1:9,b2:0,sprite:40},
			{is_trainer:0,b1:2,b2:0,sprite:24},
			{is_trainer:0,b1:2,b2:0,sprite:17},
		]},
	{
		signs:[
			{x:5,y:12},
			{x:1,y:12},
		]},
	{
		triggers:[
		]},

},
[
	[17, 17, 17, 17, 17, 17, 17, 17, 17, 17, 17, 17, 17, 17, 17, ],
	[17, 17, 17, 17, 17, 17, 17, 17, 17, 17, 17, 17, 17, 17, 17, ],
	[17, 17, 17, 17, 17, 17, 17, 17, 17, 17, 17, 17, 17, 17, 17, ],
	[17, 17, 17, 0, 17, 17, 17, 17, 17, 0, 17, 17, 17, 17, 17, ],
	[17, 17, 17, 0, 17, 17, 17, 16, 17, 0, 17, 17, 17, 17, 17, ],
	[16, 16, 17, 16, 17, 16, 16, 16, 16, 16, 17, 16, 17, 16, 16, ],
	[16, 16, 16, 16, 16, 16, 16, 16, 16, 16, 16, 16, 16, 16, 16, ],
	[16, 16, 16, 16, 16, 16, 16, 16, 16, 16, 16, 16, 16, 16, 16, ],
	[16, 16, 16, 17, 17, 17, 17, 16, 17, 17, 17, 17, 16, 16, 16, ],
	[16, 16, 16, 17, 17, 17, 17, 16, 17, 17, 17, 17, 16, 16, 16, ],
	[0, 0, 0, 17, 17, 17, 17, 16, 17, 17, 17, 17, 17, 17, 17, ],
	[1, 1, 0, 17, 17, 1, 17, 16, 17, 17, 17, 17, 17, 1, 17, ],
	[1, 1, 1, 17, 17, 1, 17, 16, 17, 17, 17, 17, 17, 1, 17, ],
	[0, 0, 0, 16, 16, 0, 16, 16, 16, 16, 16, 16, 16, 16, 16, ],
	[16, 16, 16, 16, 16, 16, 16, 16, 16, 16, 16, 16, 16, 16, 16, ],
	[16, 16, 16, 16, 16, 16, 16, 16, 16, 16, 16, 16, 16, 16, 16, ],
	[16, 16, 16, 16, 16, 16, 16, 16, 16, 16, 16, 16, 16, 16, 16, ],
	[16, 16, 16, 16, 16, 16, 16, 16, 16, 16, 16, 16, 16, 16, 16, ],
]
