Connections;
Exits;BATTLE FRONTIER (26.14);BATTLE FRONTIER (26.14);
1 1 1 1 1 1 1 1 1 1 1 1 1 1 1 1 1 1 1 1 1 1 1 1 1 1 1 1 1 1 1 1 1 1 1 1 1 1 1 1 1 1 1 1 1 1 1 1 1 1 1 1 1 
1 1 1 1 1 1 1 1 1 1 1 1 1 1 1 1 1 1 1 1 1 1 1 1 1 1 1 1 1 1 1 1 1 1 1 1 1 1 1 1 1 1 1 1 1 1 1 1 1 1 1 1 1 
1 1 1 1 1 1 1 1 1 1 1 1 1 1 1 1 1 1 1 1 1 1 1 1 1 1 1 1 1 1 1 1 1 1 1 1 1 1 1 1 1 1 1 1 1 1 1 1 1 1 1 1 1 
1 1 1 1 1 1 1 1 1 1 1 1 1 1 1 1 1 1 1 1 1 1 1 12 12 12 12 12 12 12 1 1 1 1 1 1 1 1 1 1 1 1 1 1 1 1 1 1 1 1 1 1 1 
1 1 1 1 1 1 1 1 1 1 1 1 1 1 1 1 1 1 1 1 1 12 12 12 12 12 12 12 12 12 12 12 1 1 1 1 1 1 1 1 1 1 1 1 1 1 1 1 1 1 1 1 1 
1 1 1 1 1 12 12 12 12 12 12 12 1 1 1 1 1 1 1 1 1 12 12 12 12 12 1 12 12 12 12 12 1 1 1 1 1 1 1 1 1 12 12 12 12 12 12 12 1 1 1 1 1 
1 1 1 1 1 12 12 12 12 12 12 12 1 1 1 1 1 1 1 1 1 12 12 12 12 12 12 12 12 12 12 12 1 1 1 1 1 1 1 1 1 12 12 12 12 12 12 12 1 1 1 1 1 
1 1 1 12 12 12 12 12 1 12 12 12 12 12 1 1 1 1 1 12 12 12 12 12 12 12 12 12 12 12 12 12 12 12 1 1 1 1 1 12 12 12 12 12 1 12 12 12 12 12 1 1 1 
1 1 1 12 12 12 12 12 12 12 12 12 12 12 1 1 1 1 1 12 12 12 12 1 12 12 12 12 12 1 12 12 12 12 1 1 1 1 1 12 12 12 12 12 12 12 12 12 12 12 1 1 1 
1 1 1 12 12 12 1 12 12 12 1 12 12 12 12 12 12 12 12 12 12 12 12 12 12 1 1 1 12 12 12 12 12 12 12 12 12 12 12 12 12 12 1 12 12 12 1 12 12 12 1 1 1 
1 1 1 12 12 12 12 12 12 12 12 12 12 12 12 12 12 12 12 12 12 12 12 12 12 12 12 12 12 12 12 12 12 12 12 12 12 12 12 12 12 12 12 12 12 12 12 12 12 12 1 1 1 
1 1 1 12 12 12 12 12 12 12 12 12 12 12 1 1 1 1 1 12 12 12 12 12 12 12 12 12 12 12 12 12 12 12 1 1 1 1 1 12 12 12 12 12 12 12 12 12 12 12 1 1 1 
1 1 1 1 1 12 12 12 12 12 12 12 1 1 1 1 1 1 1 1 1 12 12 12 12 12 12 12 12 12 12 12 1 1 1 1 1 1 1 1 1 12 12 12 12 12 12 12 1 1 1 1 1 
1 1 1 1 1 12 12 12 12 12 12 12 1 1 1 1 1 1 1 1 1 12 12 12 12 12 12 12 12 12 12 12 1 1 1 1 1 1 1 1 1 12 12 12 12 12 12 12 1 1 1 1 1 
1 1 1 1 1 1 1 1 1 1 1 1 1 1 1 1 1 1 1 1 1 1 1 12 12 12 12 12 12 12 1 1 1 1 1 1 1 1 1 1 1 1 1 1 1 1 1 1 1 1 1 1 1 
