connections=[
		],
events={
	
		'exits':[		],
	
		'NPCs':[
			{'is_trainer':0,'b1':8,'b2':0,'sprite':'28','x':6,'y':6},
		],
	
		'signs':[
		],
	
		'triggers':[
		],

},
partial_map=[
	[1, 1, 1, 1, 1, 1, 1, 1, 1, 1, 1, 1, 1, 1, ],
	[1, 1, 1, 1, 1, 1, 1, 1, 1, 1, 1, 1, 1, 1, ],
	[13, 13, 13, 13, 13, 13, 13, 13, 13, 1, 1, 1, 1, 1, ],
	[1, 1, 1, 1, 1, 1, 12, 1, 1, 1, 1, 1, 1, 1, ],
	[12, 12, 12, 1, 12, 12, 12, 12, 12, 1, 12, 12, 12, 12, ],
	[12, 12, 12, 12, 12, 12, 12, 12, 12, 12, 12, 12, 12, 12, ],
	[12, 12, 12, 12, 1, 12, 12, 12, 1, 12, 12, 12, 12, 12, ],
	[12, 12, 1, 12, 12, 12, 12, 12, 12, 12, 1, 12, 12, 12, ],
]
