connections=[
		],
events={
	{
		exits:[BATTLE FRONTIER (26.4),BATTLE FRONTIER (26.4),		]},
	{
		NPCs:[
			{is_trainer:0,b1:10,b2:0,sprite:39},
			{is_trainer:0,b1:9,b2:0,sprite:39},
			{is_trainer:0,b1:9,b2:0,sprite:39},
			{is_trainer:0,b1:2,b2:0,sprite:52},
			{is_trainer:0,b1:9,b2:0,sprite:39},
		]},
	{
		signs:[
		]},
	{
		triggers:[
		]},

},
[
	[1, 1, 1, 1, 1, 1, 1, 1, 1, 1, 1, 1, 1, ],
	[1, 1, 1, 1, 1, 1, 1, 1, 1, 1, 1, 1, 1, ],
	[12, 1, 1, 1, 1, 1, 12, 1, 1, 1, 1, 1, 12, ],
	[12, 12, 12, 12, 12, 12, 12, 12, 12, 12, 12, 12, 12, ],
	[12, 12, 12, 12, 12, 12, 1, 12, 12, 12, 12, 12, 12, ],
	[12, 12, 12, 12, 12, 12, 12, 12, 12, 12, 12, 12, 12, ],
	[12, 12, 12, 12, 12, 12, 1, 12, 12, 12, 12, 12, 12, ],
	[1, 12, 12, 12, 12, 12, 12, 12, 12, 12, 12, 12, 1, ],
]
