Connections;
Exits;BATTLE FRONTIER (26.14);
13 13 13 13 13 13 13 13 13 13 13 13 13 13 13 13 
13 13 13 13 13 13 13 13 13 13 13 13 13 13 13 13 
13 13 13 13 13 13 13 13 13 13 13 13 13 13 13 13 
17 17 17 17 17 17 17 0 17 17 17 17 17 17 17 17 
17 17 17 17 17 17 17 17 17 17 17 17 17 17 17 17 
17 17 17 17 17 17 17 17 17 17 17 17 17 17 17 17 
1 1 1 12 17 17 17 17 17 17 17 12 1 13 1 1 
1 1 1 12 17 17 17 1 17 17 17 12 1 12 1 1 
12 12 12 12 12 1 12 0 12 12 12 12 12 12 12 1 
12 12 12 12 12 1 12 12 12 12 12 12 12 12 12 1 
1 12 12 12 12 12 12 12 12 12 12 12 12 12 12 1 
1 12 12 12 12 12 12 12 12 12 12 12 12 12 12 1 
12 12 12 12 12 12 12 12 12 12 12 12 12 12 12 1 
