Connections;
Exits;BATTLE FRONTIER (26.23);BATTLE FRONTIER (26.23);
12 12 13 12 12 13 12 12 13 12 12 13 13 12 1 
12 12 13 12 12 13 12 12 13 12 12 13 13 12 1 
12 12 13 12 12 13 12 12 13 12 12 13 0 0 0 
12 12 12 12 12 13 13 13 13 13 13 12 12 12 12 
12 12 12 0 13 13 13 13 13 13 13 0 12 12 12 
12 12 12 12 1 1 1 1 1 1 1 0 12 12 12 
12 12 0 0 1 1 1 1 1 1 1 0 12 12 12 
12 12 0 0 0 0 0 0 0 0 0 0 12 12 12 
12 12 0 0 0 0 0 0 0 0 0 0 12 12 12 
12 12 0 0 0 0 0 0 0 0 0 0 0 0 0 
