connections=[
		],
events={
	{
		exits:[BATTLE FRONTIER (26.5),BATTLE FRONTIER (26.5),		]},
	{
		NPCs:[
			{is_trainer:0,b1:8,b2:0,sprite:240},
			{is_trainer:0,b1:10,b2:0,sprite:85},
			{is_trainer:0,b1:7,b2:0,sprite:85},
		]},
	{
		signs:[
		]},
	{
		triggers:[
		]},

},
[
	[1, 1, 1, 1, 1, 1, 1, 1, 1, 1, ],
	[1, 1, 1, 1, 12, 12, 1, 1, 1, 1, ],
	[1, 12, 12, 12, 12, 12, 12, 12, 12, 1, ],
	[12, 12, 12, 12, 12, 12, 12, 12, 12, 12, ],
	[12, 12, 12, 12, 12, 12, 12, 12, 12, 12, ],
	[12, 12, 12, 12, 12, 12, 12, 12, 12, 12, ],
	[12, 12, 12, 12, 12, 12, 12, 12, 12, 12, ],
	[12, 12, 12, 12, 12, 12, 12, 12, 12, 12, ],
	[1, 12, 12, 12, 12, 12, 12, 12, 12, 1, ],
]
