Connections;
Exits;BATTLE FRONTIER (26.4);BATTLE FRONTIER (26.4);BATTLE FRONTIER (26.4);
13 13 13 1 13 13 13 13 13 13 13 
13 1 13 1 13 13 13 13 13 1 13 
1 1 1 1 1 1 1 1 1 1 1 
1 1 1 12 1 12 1 12 1 1 1 
12 12 12 1 12 12 12 1 12 12 12 
12 12 12 12 1 12 1 12 12 12 12 
12 12 12 12 12 12 12 12 12 12 12 
12 1 12 12 12 12 12 12 12 1 12 
1 12 12 1 12 12 12 1 12 12 1 
12 12 12 12 12 12 12 12 12 12 12 
12 1 12 12 12 12 12 12 12 1 12 
12 12 12 12 12 12 12 12 12 12 12 
12 12 12 1 12 12 12 1 12 12 12 
