connections=[
		],
events={
	{
		exits:[BATTLE FRONTIER (26.14),BATTLE FRONTIER (26.14),BATTLE FRONTIER (26.8),		]},
	{
		NPCs:[
			{is_trainer:0,b1:8,b2:0,sprite:85},
			{is_trainer:0,b1:8,b2:0,sprite:65},
			{is_trainer:0,b1:2,b2:0,sprite:34},
			{is_trainer:0,b1:2,b2:0,sprite:7},
			{is_trainer:0,b1:10,b2:0,sprite:68},
			{is_trainer:0,b1:8,b2:0,sprite:240},
			{is_trainer:0,b1:8,b2:0,sprite:85},
			{is_trainer:0,b1:8,b2:0,sprite:85},
			{is_trainer:0,b1:8,b2:0,sprite:85},
		]},
	{
		signs:[
			{x:4,y:5},
			{x:8,y:5},
			{x:12,y:5},
			{x:16,y:5},
			{x:2,y:1},
		]},
	{
		triggers:[
		]},

},
[
	[1, 1, 1, 1, 1, 1, 1, 1, 1, 1, 1, 1, 1, 1, 1, 1, 1, 1, 1, 1, 1, 1, 1, 1, 1, ],
	[1, 1, 1, 1, 1, 1, 1, 1, 1, 1, 1, 1, 1, 1, 1, 1, 1, 1, 1, 1, 1, 1, 1, 1, 1, ],
	[12, 0, 0, 0, 1, 0, 0, 0, 1, 0, 0, 0, 1, 0, 0, 0, 1, 0, 0, 0, 1, 12, 12, 12, 12, ],
	[12, 12, 12, 12, 1, 0, 12, 12, 1, 0, 12, 12, 1, 0, 12, 12, 1, 0, 12, 12, 1, 12, 12, 12, 12, ],
	[12, 12, 12, 12, 1, 0, 12, 0, 1, 0, 12, 0, 1, 0, 12, 0, 1, 0, 12, 0, 1, 12, 12, 12, 12, ],
	[12, 12, 12, 12, 1, 1, 12, 1, 1, 1, 12, 1, 1, 1, 12, 1, 1, 1, 12, 1, 1, 12, 12, 12, 12, ],
	[12, 12, 12, 12, 12, 0, 0, 0, 12, 0, 0, 0, 12, 0, 0, 0, 12, 0, 0, 0, 12, 12, 12, 12, 12, ],
	[12, 12, 12, 12, 12, 12, 12, 12, 12, 12, 12, 12, 12, 12, 12, 12, 12, 12, 12, 12, 12, 12, 12, 12, 12, ],
	[12, 12, 12, 12, 12, 12, 12, 12, 12, 12, 12, 12, 12, 12, 12, 12, 12, 12, 12, 12, 12, 12, 12, 12, 12, ],
	[1, 1, 12, 12, 12, 12, 12, 12, 12, 12, 12, 12, 12, 12, 12, 12, 12, 12, 12, 12, 12, 12, 12, 1, 1, ],
]
