Connections;
Exits;BATTLE FRONTIER (26.14);
17 17 17 17 17 17 17 17 17 17 17 17 17 17 17 
17 17 17 17 17 17 17 17 17 17 17 17 17 17 17 
17 17 17 17 17 17 17 17 17 17 17 17 17 17 17 
17 17 17 0 17 17 17 17 17 0 17 17 17 17 17 
17 17 17 0 17 17 17 16 17 0 17 17 17 17 17 
16 16 17 16 17 16 16 16 16 16 17 16 17 16 16 
16 16 16 16 16 16 16 16 16 16 16 16 16 16 16 
16 16 16 16 16 16 16 16 16 16 16 16 16 16 16 
16 16 16 17 17 17 17 16 17 17 17 17 16 16 16 
16 16 16 17 17 17 17 16 17 17 17 17 16 16 16 
0 0 0 17 17 17 17 16 17 17 17 17 17 17 17 
1 1 0 17 17 1 17 16 17 17 17 17 17 1 17 
1 1 1 17 17 1 17 16 17 17 17 17 17 1 17 
0 0 0 16 16 0 16 16 16 16 16 16 16 16 16 
16 16 16 16 16 16 16 16 16 16 16 16 16 16 16 
16 16 16 16 16 16 16 16 16 16 16 16 16 16 16 
16 16 16 16 16 16 16 16 16 16 16 16 16 16 16 
16 16 16 16 16 16 16 16 16 16 16 16 16 16 16 
