connections=[
		],
events={
	{
		exits:[BATTLE FRONTIER (26.4),BATTLE FRONTIER (26.4),BATTLE FRONTIER (26.4),		]},
	{
		NPCs:[
			{is_trainer:0,b1:8,b2:0,sprite:28},
			{is_trainer:0,b1:7,b2:0,sprite:55},
			{is_trainer:0,b1:9,b2:0,sprite:6},
			{is_trainer:0,b1:2,b2:0,sprite:45},
		]},
	{
		signs:[
			{x:8,y:3},
			{x:1,y:3},
		]},
	{
		triggers:[
		]},

},
[
	[13, 13, 13, 1, 13, 13, 13, 13, 13, 13, 13, ],
	[13, 1, 13, 1, 13, 13, 13, 13, 13, 1, 13, ],
	[1, 1, 1, 1, 1, 1, 1, 1, 1, 1, 1, ],
	[1, 1, 1, 12, 1, 12, 1, 12, 1, 1, 1, ],
	[12, 12, 12, 1, 12, 12, 12, 1, 12, 12, 12, ],
	[12, 12, 12, 12, 1, 12, 1, 12, 12, 12, 12, ],
	[12, 12, 12, 12, 12, 12, 12, 12, 12, 12, 12, ],
	[12, 1, 12, 12, 12, 12, 12, 12, 12, 1, 12, ],
	[1, 12, 12, 1, 12, 12, 12, 1, 12, 12, 1, ],
	[12, 12, 12, 12, 12, 12, 12, 12, 12, 12, 12, ],
	[12, 1, 12, 12, 12, 12, 12, 12, 12, 1, 12, ],
	[12, 12, 12, 12, 12, 12, 12, 12, 12, 12, 12, ],
	[12, 12, 12, 1, 12, 12, 12, 1, 12, 12, 12, ],
]
