Connections;
Exits;BATTLE FRONTIER (26.14);BATTLE FRONTIER (26.14);BATTLE FRONTIER (26.23);
0 0 0 0 0 0 0 0 0 0 0 0 0 0 0 0 0 0 0 0 0 0 0 0 0 
1 0 0 1 0 0 0 1 0 0 0 0 1 0 0 0 0 1 0 0 0 1 0 0 1 
13 0 0 13 12 12 12 13 12 12 12 12 13 13 13 13 12 13 12 12 12 13 12 0 13 
13 0 0 13 13 0 13 13 12 1 1 1 13 13 13 13 12 13 13 0 13 13 12 0 13 
13 13 13 13 13 12 13 13 13 1 1 1 13 13 13 13 13 13 13 12 13 13 13 13 13 
0 0 1 1 0 0 0 1 1 0 0 0 0 0 0 0 1 1 0 0 0 1 1 0 0 
0 0 1 1 1 0 1 1 1 0 0 0 0 0 0 0 1 1 1 0 1 1 1 0 0 
0 0 1 0 0 0 0 0 0 0 0 0 0 0 0 0 1 0 0 0 0 0 0 0 0 
0 0 0 0 0 0 0 0 0 0 0 0 0 0 0 0 0 0 0 0 0 0 0 0 0 
0 0 0 0 0 0 0 0 0 0 0 0 0 0 0 0 0 0 0 0 0 0 0 0 0 
0 0 0 0 0 0 0 0 0 0 0 0 0 0 0 0 0 0 0 0 0 0 0 0 0 
0 0 0 0 0 0 0 0 0 0 0 0 0 0 0 0 0 0 0 0 0 0 0 0 0 
