connections=[
		],
events={
	{
		exits:[BATTLE FRONTIER (26.14),		]},
	{
		NPCs:[
			{is_trainer:0,b1:8,b2:0,sprite:44},
			{is_trainer:0,b1:2,b2:0,sprite:34},
			{is_trainer:0,b1:9,b2:0,sprite:66},
			{is_trainer:0,b1:9,b2:0,sprite:31},
			{is_trainer:0,b1:9,b2:0,sprite:35},
		]},
	{
		signs:[
			{x:5,y:9},
			{x:1,y:7},
		]},
	{
		triggers:[
		]},

},
[
	[13, 13, 13, 13, 13, 13, 13, 13, 13, 13, 13, 13, 13, 13, 13, 13, ],
	[13, 13, 13, 13, 13, 13, 13, 13, 13, 13, 13, 13, 13, 13, 13, 13, ],
	[13, 13, 13, 13, 13, 13, 13, 13, 13, 13, 13, 13, 13, 13, 13, 13, ],
	[17, 17, 17, 17, 17, 17, 17, 0, 17, 17, 17, 17, 17, 17, 17, 17, ],
	[17, 17, 17, 17, 17, 17, 17, 17, 17, 17, 17, 17, 17, 17, 17, 17, ],
	[17, 17, 17, 17, 17, 17, 17, 17, 17, 17, 17, 17, 17, 17, 17, 17, ],
	[1, 1, 1, 12, 17, 17, 17, 17, 17, 17, 17, 12, 1, 13, 1, 1, ],
	[1, 1, 1, 12, 17, 17, 17, 1, 17, 17, 17, 12, 1, 12, 1, 1, ],
	[12, 12, 12, 12, 12, 1, 12, 0, 12, 12, 12, 12, 12, 12, 12, 1, ],
	[12, 12, 12, 12, 12, 1, 12, 12, 12, 12, 12, 12, 12, 12, 12, 1, ],
	[1, 12, 12, 12, 12, 12, 12, 12, 12, 12, 12, 12, 12, 12, 12, 1, ],
	[1, 12, 12, 12, 12, 12, 12, 12, 12, 12, 12, 12, 12, 12, 12, 1, ],
	[12, 12, 12, 12, 12, 12, 12, 12, 12, 12, 12, 12, 12, 12, 12, 1, ],
]
