connections=[
		],
events={
	{
		exits:[BATTLE FRONTIER (26.22),BATTLE FRONTIER (26.22),BATTLE FRONTIER (26.24),BATTLE FRONTIER (26.24),		]},
	{
		NPCs:[
			{is_trainer:0,b1:7,b2:0,sprite:21},
			{is_trainer:0,b1:2,b2:0,sprite:214},
			{is_trainer:0,b1:14,b2:0,sprite:225},
			{is_trainer:0,b1:1,b2:0,sprite:209},
			{is_trainer:0,b1:14,b2:0,sprite:208},
			{is_trainer:0,b1:1,b2:0,sprite:210},
			{is_trainer:0,b1:2,b2:0,sprite:211},
		]},
	{
		signs:[
		]},
	{
		triggers:[
		]},

},
[
	[13, 13, 13, 13, 13, 13, 13, 13, 13, 13, 13, 13, 13, 13, 13, 13, 12, ],
	[13, 13, 13, 13, 12, 13, 13, 13, 13, 13, 13, 13, 12, 13, 13, 13, 13, ],
	[13, 13, 13, 13, 12, 13, 12, 13, 13, 13, 12, 13, 12, 13, 13, 13, 13, ],
	[13, 13, 13, 13, 13, 13, 12, 13, 13, 13, 12, 13, 13, 13, 13, 13, 13, ],
	[12, 12, 12, 12, 12, 0, 0, 0, 12, 0, 0, 0, 12, 12, 12, 12, 12, ],
	[0, 0, 0, 0, 0, 12, 12, 12, 12, 12, 12, 12, 0, 0, 0, 0, 0, ],
	[12, 12, 12, 0, 0, 12, 12, 12, 12, 12, 12, 12, 0, 0, 12, 12, 12, ],
	[12, 12, 12, 0, 0, 12, 12, 12, 12, 12, 12, 12, 0, 0, 12, 12, 12, ],
	[12, 12, 12, 0, 0, 12, 12, 12, 12, 12, 12, 12, 0, 0, 12, 12, 12, ],
	[12, 12, 12, 0, 0, 12, 12, 12, 12, 12, 12, 12, 0, 0, 12, 12, 12, ],
	[12, 12, 12, 0, 0, 12, 12, 12, 12, 12, 12, 12, 0, 0, 12, 12, 12, ],
	[12, 12, 12, 0, 0, 12, 12, 12, 12, 12, 12, 12, 0, 0, 12, 12, 12, ],
	[12, 12, 12, 0, 0, 12, 12, 12, 12, 12, 12, 12, 0, 0, 12, 12, 12, ],
	[12, 12, 12, 12, 12, 12, 12, 12, 12, 12, 12, 12, 12, 12, 12, 12, 12, ],
]
