Connections;
Exits;
0 0 0 0 0 0 0 0 0 0 0 0 0 0 0 0 0 0 0 0 0 0 0 0 0 0 0 0 0 0 0 0 0 0 
0 0 0 0 0 0 0 0 0 0 0 0 0 0 0 0 0 0 0 0 0 0 0 0 0 0 0 0 0 0 0 0 0 0 
0 1 1 1 1 1 1 1 1 1 1 1 1 1 1 1 1 1 1 1 1 1 1 1 1 1 1 1 1 1 1 1 1 1 
1 1 1 1 1 1 1 1 1 1 1 1 1 1 1 1 1 1 1 1 1 1 1 1 1 1 1 1 1 1 1 1 1 1 
1 1 1 1 1 1 1 1 1 1 1 1 1 1 1 1 1 1 1 1 1 1 1 1 1 1 1 1 1 1 1 1 1 1 
1 1 1 1 1 1 1 1 1 1 1 1 1 1 1 1 1 1 1 1 1 1 1 1 1 1 1 1 1 1 1 1 1 1 
1 1 1 1 1 1 1 1 1 1 1 1 1 1 1 1 1 1 1 1 1 1 1 1 1 1 1 1 1 1 1 1 1 1 
1 1 1 1 1 1 1 1 1 1 1 1 1 1 1 1 16 16 16 1 1 1 1 1 1 1 1 1 1 1 1 1 1 1 
1 1 1 1 1 1 1 1 1 1 1 1 1 1 24 24 16 16 16 24 24 1 1 1 1 1 1 1 1 1 1 1 1 1 
1 1 1 1 1 1 1 1 1 1 1 1 16 16 24 24 16 16 16 24 24 16 16 1 1 1 1 1 1 1 1 1 1 1 
1 1 1 1 1 1 1 1 1 1 24 24 16 16 24 24 1 0 1 24 24 16 16 24 24 1 1 1 1 1 1 1 1 1 
1 1 1 1 1 1 1 1 16 16 24 24 16 16 24 24 24 24 24 24 24 16 16 24 24 16 16 1 1 1 1 1 1 1 
1 1 1 1 1 1 1 1 16 16 24 24 16 16 1 1 1 0 1 1 1 16 16 24 24 16 16 1 1 1 1 1 1 1 
1 1 1 1 1 1 1 1 16 16 24 24 16 16 16 16 16 16 16 16 16 16 16 24 24 16 16 1 1 1 1 1 1 1 
1 1 1 1 1 1 1 1 16 16 24 24 1 1 1 1 1 0 1 1 1 1 1 24 24 16 16 1 1 1 1 1 1 1 
1 1 1 1 1 1 1 1 16 16 24 24 24 24 24 24 24 24 24 24 24 24 24 24 24 16 16 1 1 1 1 1 1 1 
1 1 1 1 1 1 1 1 16 16 1 1 1 1 1 1 1 0 1 1 1 1 1 1 1 16 16 1 1 1 1 1 1 1 
1 1 1 1 1 1 1 1 16 16 16 16 16 16 16 16 16 16 16 16 16 16 16 16 16 16 16 1 1 1 1 1 1 1 
1 1 1 1 1 1 1 1 1 1 1 1 1 1 1 1 1 1 1 1 1 1 1 1 1 1 1 1 1 1 1 1 1 1 
1 1 1 1 1 1 1 1 16 16 16 16 16 16 16 16 16 16 16 16 16 16 16 16 16 16 16 1 1 1 1 1 1 1 
1 1 1 1 1 1 1 1 1 1 1 1 1 1 1 1 1 1 1 1 1 1 1 1 1 1 1 1 1 1 1 1 1 1 
1 1 1 1 1 1 16 16 16 16 16 16 16 16 16 16 16 16 16 16 16 16 16 16 16 16 16 16 16 1 1 1 1 1 
1 1 1 1 1 1 1 1 1 1 1 1 1 1 1 1 1 1 1 1 1 1 1 1 1 1 1 1 1 1 1 1 1 1 
