Connections;
Exits;CAVE OF ORIGIN (24.39);CAVE OF ORIGIN (24.41);
1 1 1 1 1 1 1 1 1 1 1 1 1 1 1 1 1 1 1 1 1 
1 1 1 1 1 1 1 1 1 1 1 1 1 1 1 1 1 1 1 1 1 
1 1 1 1 1 1 1 1 1 1 1 1 1 1 1 1 1 1 1 1 1 
1 1 1 1 1 1 1 1 1 1 1 1 1 1 1 1 1 1 1 1 1 
1 1 1 1 1 1 1 1 1 1 1 1 1 1 1 1 1 1 1 1 1 
1 1 1 1 1 1 1 12 12 12 12 12 12 12 12 1 1 1 1 1 1 
1 1 1 1 1 1 1 12 12 12 12 12 12 12 12 12 1 1 1 1 1 
1 1 1 1 1 12 12 12 1 1 1 1 12 12 12 12 1 1 1 1 1 
1 1 1 1 1 12 12 1 1 1 1 1 1 12 12 12 1 1 1 1 1 
1 1 1 1 1 12 12 1 1 1 1 1 1 1 12 12 1 1 1 1 1 
1 1 1 1 1 12 12 1 1 1 1 1 1 1 12 12 1 1 1 1 1 
1 1 1 1 1 1 1 1 1 1 1 1 1 1 12 12 1 1 1 1 1 
1 1 1 1 1 1 1 1 1 1 1 1 1 1 12 12 1 1 1 1 1 
1 1 1 1 1 1 1 1 1 1 1 1 12 12 12 12 1 1 1 1 1 
1 1 1 1 1 1 1 1 12 12 12 12 12 12 12 1 1 1 1 1 1 
1 1 1 1 1 1 1 1 12 12 12 12 12 12 1 1 1 1 1 1 1 
1 1 1 1 1 1 1 1 1 1 1 1 1 1 1 1 1 1 1 1 1 
1 1 1 1 1 1 1 1 1 1 1 1 1 1 1 1 1 1 1 1 1 
1 1 1 1 1 1 1 1 1 1 1 1 1 1 1 1 1 1 1 1 1 
1 1 1 1 1 1 1 1 1 1 1 1 1 1 1 1 1 1 1 1 1 
1 1 1 1 1 1 1 1 1 1 1 1 1 1 1 1 1 1 1 1 1 
