Connections;
Exits;SOOTOPOLIS CITY (0.7);CAVE OF ORIGIN (24.38);
1 1 1 1 1 1 1 1 1 1 1 1 1 1 1 1 1 1 1 
1 1 1 1 1 1 1 1 1 1 1 1 1 1 1 1 1 1 1 
1 1 1 1 1 1 1 1 1 1 1 1 1 1 1 1 1 1 1 
1 1 1 1 1 1 1 1 1 1 1 1 1 1 1 1 1 1 1 
1 1 1 1 1 1 1 1 1 1 1 1 1 1 1 1 1 1 1 
1 1 1 1 1 1 1 1 1 12 1 1 1 1 1 1 1 1 1 
1 1 1 1 1 1 1 12 12 12 12 12 1 1 1 1 1 1 1 
1 1 1 1 1 1 1 12 12 12 12 12 1 1 1 1 1 1 1 
1 1 1 1 1 1 1 12 12 12 12 12 1 1 1 1 1 1 1 
1 1 1 1 1 1 1 12 12 12 12 12 1 1 1 1 1 1 1 
1 1 1 1 1 1 1 12 12 12 12 12 1 1 1 1 1 1 1 
1 1 1 1 1 1 1 12 12 12 12 12 1 1 1 1 1 1 1 
1 1 1 1 1 1 1 12 12 12 12 12 1 1 1 1 1 1 1 
1 1 1 1 1 1 1 12 12 12 12 12 1 1 1 1 1 1 1 
1 1 1 1 1 1 1 12 12 12 12 12 1 1 1 1 1 1 1 
1 1 1 1 1 1 1 12 12 12 12 12 1 1 1 1 1 1 1 
1 1 1 1 1 1 1 12 12 12 12 12 1 1 1 1 1 1 1 
1 1 1 1 1 1 1 12 12 12 12 12 1 1 1 1 1 1 1 
1 1 1 1 1 1 1 12 12 12 12 12 1 1 1 1 1 1 1 
1 1 1 1 1 1 1 12 12 12 12 12 1 1 1 1 1 1 1 
1 1 1 1 1 1 1 12 12 12 12 12 1 1 1 1 1 1 1 
1 1 1 1 1 1 1 1 1 1 1 1 1 1 1 1 1 1 1 
1 1 1 1 1 1 1 1 1 1 1 1 1 1 1 1 1 1 1 
1 1 1 1 1 1 1 1 1 1 1 1 1 1 1 1 1 1 1 
1 1 1 1 1 1 1 1 1 1 1 1 1 1 1 1 1 1 1 
1 1 1 1 1 1 1 1 1 1 1 1 1 1 1 1 1 1 1 
