Connections;
Exits;CAVE OF ORIGIN (24.38);
1 1 1 1 1 1 1 1 1 1 1 1 1 1 1 1 1 1 1 
1 1 1 1 1 1 1 1 1 1 1 1 1 1 1 1 1 1 1 
1 1 1 1 1 1 1 1 1 1 1 1 1 1 1 1 1 1 1 
1 1 1 1 1 1 1 12 12 12 12 12 1 1 1 1 1 1 1 
1 1 1 1 1 12 12 12 12 12 12 12 12 12 1 1 1 1 1 
1 1 1 1 12 12 12 1 1 1 1 1 12 12 12 1 1 1 1 
1 1 1 1 12 12 1 1 8 1 8 1 1 12 12 1 1 1 1 
1 1 1 1 12 1 1 1 8 8 8 1 1 1 12 1 1 1 1 
1 1 1 1 12 1 8 8 8 8 8 8 8 1 12 1 1 1 1 
1 1 1 1 12 1 1 8 8 1 8 8 1 1 12 1 1 1 1 
1 1 1 1 12 1 8 8 8 8 8 8 8 1 12 1 1 1 1 
1 1 1 1 12 12 1 1 8 8 8 1 1 12 12 1 1 1 1 
1 1 1 1 12 12 12 1 8 1 8 1 12 12 12 1 1 1 1 
1 1 1 1 1 12 12 12 12 12 12 12 12 12 1 1 1 1 1 
1 1 1 1 1 1 12 12 12 12 12 12 12 1 1 1 1 1 1 
1 1 1 1 1 1 1 1 1 1 1 1 1 1 1 1 1 1 1 
1 1 1 1 1 1 1 1 1 1 1 1 1 1 1 1 1 1 1 
1 1 1 1 1 1 1 1 1 1 1 1 1 1 1 1 1 1 1 
1 1 1 1 1 1 1 1 1 1 1 1 1 1 1 1 1 1 1 
