Connections;
Exits;CAVE OF ORIGIN (24.40);CAVE OF ORIGIN (24.42);
1 1 1 1 1 1 1 1 1 1 1 1 1 1 1 1 1 1 1 
1 1 1 1 1 1 1 1 1 1 1 1 1 1 1 1 1 1 1 
1 1 1 1 1 1 1 1 1 1 1 1 1 1 1 1 1 1 1 
1 1 1 1 1 1 1 1 1 1 1 1 1 1 1 1 1 1 1 
1 1 1 1 1 1 1 1 1 1 1 1 1 1 1 1 1 1 1 
1 1 1 1 1 1 12 12 12 12 12 12 12 1 1 1 1 1 1 
1 1 1 1 1 1 12 12 12 12 12 12 12 12 1 1 1 1 1 
1 1 1 1 1 12 12 1 1 1 1 1 12 12 1 1 1 1 1 
1 1 1 1 1 12 1 1 1 1 1 1 1 12 1 1 1 1 1 
1 1 1 1 1 12 1 1 1 1 1 1 1 1 1 1 1 1 1 
1 1 1 1 1 12 1 1 1 1 1 1 1 1 1 1 1 1 1 
1 1 1 1 1 12 12 1 1 1 1 1 1 1 1 1 1 1 1 
1 1 1 1 1 12 12 12 1 1 1 1 1 1 1 1 1 1 1 
1 1 1 1 1 12 12 12 1 1 1 1 1 1 1 1 1 1 1 
1 1 1 1 1 1 12 12 12 12 12 12 1 1 1 1 1 1 1 
1 1 1 1 1 1 12 12 12 12 12 12 1 1 1 1 1 1 1 
1 1 1 1 1 1 1 1 1 1 1 1 1 1 1 1 1 1 1 
1 1 1 1 1 1 1 1 1 1 1 1 1 1 1 1 1 1 1 
1 1 1 1 1 1 1 1 1 1 1 1 1 1 1 1 1 1 1 
1 1 1 1 1 1 1 1 1 1 1 1 1 1 1 1 1 1 1 
1 1 1 1 1 1 1 1 1 1 1 1 1 1 1 1 1 1 1 
