Connections;
Exits;DEWFORD TOWN (0.11);DEWFORD TOWN (0.11);
1 1 1 1 1 1 1 1 1 1 1 1 1 1 1 1 1 1 
1 1 1 1 1 1 1 1 1 1 1 1 1 1 1 1 1 1 
1 1 1 1 1 1 1 1 1 1 1 1 1 1 1 1 1 1 
1 1 1 0 0 1 1 1 1 1 0 1 1 1 1 0 1 1 
1 0 1 0 0 1 0 1 1 1 0 0 1 1 1 0 1 1 
1 4 0 0 0 0 4 4 4 4 4 4 0 1 1 0 1 1 
1 1 4 4 4 4 1 1 1 1 1 1 0 0 4 4 1 1 
1 1 1 1 1 1 1 1 1 1 1 1 0 0 1 1 1 1 
1 1 1 1 1 1 1 4 4 0 4 4 0 4 1 1 1 1 
1 1 0 1 1 1 1 1 1 0 1 1 0 1 1 1 0 1 
1 0 0 4 4 1 1 1 1 0 1 1 0 1 1 1 0 1 
1 4 0 1 1 1 1 1 1 0 1 1 0 1 1 1 0 1 
1 1 0 1 1 1 1 1 1 0 1 1 0 1 4 4 0 1 
1 1 0 1 1 1 1 0 0 0 1 1 0 1 1 1 0 1 
1 1 0 1 1 0 4 4 4 4 0 0 0 1 1 1 0 1 
1 0 0 1 1 0 1 1 1 1 4 0 4 1 1 1 0 1 
1 0 0 4 4 4 1 1 1 1 1 0 1 1 1 1 0 1 
1 0 0 1 1 1 1 1 1 1 1 0 1 1 1 1 0 1 
1 1 0 1 1 1 1 1 0 1 1 0 1 1 0 0 4 1 
1 1 1 1 1 1 1 1 0 1 1 0 0 4 4 4 1 1 
1 1 1 1 1 1 1 1 0 1 1 0 0 1 1 1 1 1 
1 1 0 1 1 1 1 1 0 0 0 0 0 1 1 1 1 1 
1 1 4 0 0 0 0 0 4 4 4 4 0 4 4 4 1 1 
1 1 1 4 4 0 0 4 1 1 1 1 0 1 1 1 1 1 
1 1 1 1 1 0 0 1 1 1 1 1 0 1 1 1 1 1 
1 1 1 1 4 0 0 0 1 1 1 1 4 1 1 1 1 1 
1 1 1 1 1 0 0 1 1 1 1 1 1 1 1 1 1 1 
1 1 1 1 1 0 0 1 1 1 1 1 1 1 1 1 1 1 
