Connections;
Exits;DEWFORD TOWN (0.11);DEWFORD TOWN (0.11);
1 1 1 1 1 1 1 1 1 1 
1 1 1 1 1 1 1 1 1 1 
12 12 12 13 13 12 12 12 12 12 
12 12 12 12 12 12 12 12 12 12 
12 12 12 12 12 12 12 1 1 12 
12 12 12 12 12 12 12 1 1 12 
12 12 12 12 12 12 12 12 12 12 
12 12 12 12 12 12 12 12 12 12 
12 12 12 0 0 12 12 12 12 12 
