Connections;
Exits;EVER GRANDE CITY (0.8);EVER GRANDE CITY (0.8);EVER GRANDE CITY (16.9);EVER GRANDE CITY (16.9);EVER GRANDE CITY (16.14);
1 1 1 1 1 1 1 1 1 1 1 1 1 1 1 1 1 1 1 
1 1 1 1 1 1 1 1 1 12 12 1 1 1 1 1 1 1 1 
12 1 1 12 1 1 12 12 12 12 12 12 12 12 1 12 12 12 12 
1 1 1 1 1 1 12 12 12 12 12 12 12 12 1 1 1 1 1 
12 12 12 12 12 12 12 12 12 12 12 12 12 12 12 12 12 12 12 
12 12 12 12 12 12 12 12 12 12 12 12 12 12 12 12 12 12 12 
12 12 12 12 12 12 12 12 12 12 12 12 12 12 12 12 12 12 12 
13 16 0 12 12 12 12 12 12 12 12 12 12 12 12 12 12 1 1 
12 12 12 12 12 12 12 12 12 12 12 12 12 12 12 1 1 12 12 
12 12 12 12 12 12 12 12 12 12 12 12 12 12 12 1 1 12 12 
12 12 12 1 1 12 12 12 12 12 12 12 12 12 12 12 12 12 12 
1 1 1 1 1 12 12 12 12 12 12 12 12 12 12 12 12 12 1 
