Connections;
Exits;EVER GRANDE CITY (16.1);EVER GRANDE CITY (16.2);EVER GRANDE CITY (16.1);EVER GRANDE CITY (16.1);
1 1 1 1 1 1 1 1 1 1 1 
1 1 1 1 1 1 1 1 1 1 1 
1 1 1 1 1 0 1 1 1 1 1 
12 12 12 12 12 12 12 12 12 12 12 
12 12 12 12 12 12 12 12 12 12 12 
1 1 1 1 12 12 12 1 1 1 1 
1 1 1 1 12 12 12 1 1 1 1 
1 1 1 1 12 12 12 1 1 1 1 
1 1 1 1 12 12 12 1 1 1 1 
1 1 1 1 12 12 12 1 1 1 1 
1 1 1 1 12 12 12 1 1 1 1 
1 1 1 1 12 12 12 1 1 1 1 
1 1 1 1 12 12 12 1 1 1 1 
