Connections;
Exits;EVER GRANDE CITY (16.8);EVER GRANDE CITY (16.11);
1 1 1 1 1 1 1 1 1 1 1 1 1 
1 1 1 1 1 1 1 1 1 1 1 1 1 
1 1 1 1 1 1 1 1 1 1 1 1 1 
1 1 1 1 1 12 12 12 1 1 1 1 1 
1 1 1 1 12 12 12 12 12 1 1 1 1 
1 1 1 12 12 12 12 12 12 12 1 1 1 
1 1 12 12 12 12 12 12 12 12 12 1 1 
1 1 12 12 12 12 12 12 12 12 12 1 1 
1 1 1 12 12 12 12 12 12 12 1 1 1 
1 1 1 1 12 12 12 12 12 1 1 1 1 
1 1 1 1 1 12 12 12 1 1 1 1 1 
1 1 1 1 1 12 12 12 1 1 1 1 1 
1 1 1 1 1 12 12 12 1 1 1 1 1 
