connections=[
		],
events={
	
		'exits':[{'name':'EVER GRANDE CITY (0.8)','x':9,'y':11},{'name':'EVER GRANDE CITY (0.8)','x':10,'y':11},{'name':'EVER GRANDE CITY (16.9)','x':9,'y':1},{'name':'EVER GRANDE CITY (16.9)','x':10,'y':1},{'name':'EVER GRANDE CITY (16.14)','x':1,'y':7},		],
	
		'NPCs':[
			{'is_trainer':0,'b1':8,'b2':0,'sprite':'58','x':3,'y':2},
			{'is_trainer':0,'b1':8,'b2':0,'sprite':'83','x':16,'y':2},
			{'is_trainer':0,'b1':8,'b2':0,'sprite':'33','x':8,'y':2},
			{'is_trainer':0,'b1':8,'b2':0,'sprite':'33','x':11,'y':2},
		],
	
		'signs':[
		],
	
		'triggers':[
		],

},
partial_map=[
	[1, 1, 1, 1, 1, 1, 1, 1, 1, 1, 1, 1, 1, 1, 1, 1, 1, 1, 1, ],
	[1, 1, 1, 1, 1, 1, 1, 1, 1, 12, 12, 1, 1, 1, 1, 1, 1, 1, 1, ],
	[12, 1, 1, 12, 1, 1, 12, 12, 12, 12, 12, 12, 12, 12, 1, 12, 12, 12, 12, ],
	[1, 1, 1, 1, 1, 1, 12, 12, 12, 12, 12, 12, 12, 12, 1, 1, 1, 1, 1, ],
	[12, 12, 12, 12, 12, 12, 12, 12, 12, 12, 12, 12, 12, 12, 12, 12, 12, 12, 12, ],
	[12, 12, 12, 12, 12, 12, 12, 12, 12, 12, 12, 12, 12, 12, 12, 12, 12, 12, 12, ],
	[12, 12, 12, 12, 12, 12, 12, 12, 12, 12, 12, 12, 12, 12, 12, 12, 12, 12, 12, ],
	[13, 16, 0, 12, 12, 12, 12, 12, 12, 12, 12, 12, 12, 12, 12, 12, 12, 1, 1, ],
	[12, 12, 12, 12, 12, 12, 12, 12, 12, 12, 12, 12, 12, 12, 12, 1, 1, 12, 12, ],
	[12, 12, 12, 12, 12, 12, 12, 12, 12, 12, 12, 12, 12, 12, 12, 1, 1, 12, 12, ],
	[12, 12, 12, 1, 1, 12, 12, 12, 12, 12, 12, 12, 12, 12, 12, 12, 12, 12, 12, ],
	[1, 1, 1, 1, 1, 12, 12, 12, 12, 12, 12, 12, 12, 12, 12, 12, 12, 12, 1, ],
]
