Connections;left:ROUTE 128 (0.43);
Exits;EVER GRANDE CITY (16.10);EVER GRANDE CITY (16.12);VICTORY ROAD (24.43);VICTORY ROAD (24.43);
1 1 1 1 1 1 1 1 1 1 1 1 1 1 1 1 1 1 1 1 1 1 1 1 1 1 1 1 1 1 1 1 1 1 1 1 1 1 20 1 
1 1 1 1 1 1 1 1 1 1 1 1 1 1 1 1 1 1 1 1 1 1 1 1 1 1 1 1 1 1 1 1 1 1 1 1 1 20 1 1 
1 1 1 1 1 1 1 1 1 1 1 1 1 1 1 1 1 1 1 1 1 1 1 1 1 1 1 1 1 1 1 1 1 1 1 1 1 20 1 1 
1 1 1 1 1 1 1 1 1 1 1 1 1 1 1 1 1 1 1 1 1 1 1 1 1 1 1 1 1 1 1 1 1 1 1 1 1 1 1 1 
1 1 1 1 1 1 1 1 1 1 1 28 1 1 1 1 1 1 1 1 1 1 1 1 1 28 1 1 1 1 1 1 1 1 1 1 1 1 1 1 
1 1 1 1 1 1 1 1 1 1 28 1 1 1 1 1 1 1 1 1 1 1 1 1 1 1 28 1 1 1 1 1 1 1 1 1 1 1 1 20 
1 1 1 1 1 1 1 1 1 1 1 1 1 28 1 1 28 28 28 28 28 1 1 28 1 1 1 1 1 1 1 1 1 1 1 1 20 1 1 1 
1 1 1 1 1 28 1 1 28 28 1 1 1 28 1 1 28 28 28 28 28 1 1 28 1 1 1 28 28 28 28 1 1 20 1 1 1 1 1 1 
1 1 1 1 1 1 28 1 28 28 28 1 1 28 1 1 28 28 28 28 28 1 1 28 1 1 28 28 28 28 28 1 28 20 1 20 1 1 20 1 
1 1 1 1 1 1 28 1 28 28 28 28 1 28 1 1 28 28 28 28 28 1 1 28 1 28 28 28 28 28 28 1 28 20 20 1 1 1 1 1 
1 1 1 1 1 1 28 1 28 28 28 28 1 28 1 1 28 28 28 28 28 1 1 28 1 28 28 28 28 28 28 1 1 1 20 1 1 1 1 1 
1 1 1 1 1 1 28 1 28 28 28 28 1 28 28 28 28 28 28 28 28 28 28 28 1 28 28 28 28 28 28 1 1 1 1 1 1 1 1 1 
1 1 1 1 1 1 28 1 28 28 28 28 1 28 28 28 28 28 28 28 28 28 28 28 1 28 28 28 28 28 28 28 1 1 1 1 1 1 1 1 
1 1 1 1 1 1 1 1 28 28 28 28 1 28 28 1 28 28 28 28 28 1 28 28 1 28 28 28 28 28 28 28 1 28 28 1 1 1 1 1 
1 1 1 1 1 1 1 1 28 28 28 28 1 1 1 1 28 28 28 28 28 1 1 1 1 1 1 1 1 1 1 28 1 28 1 1 1 1 1 1 
1 1 1 1 1 1 1 1 28 28 28 28 28 28 1 1 28 28 28 28 28 1 28 1 28 28 28 28 28 28 1 28 1 28 1 1 1 1 1 1 
1 1 1 1 1 1 1 1 28 28 28 28 28 28 1 28 28 28 28 28 28 28 28 28 28 28 28 28 28 28 1 28 1 1 1 1 1 1 1 1 
1 1 1 1 1 1 1 1 28 28 28 28 28 28 1 28 28 28 28 28 28 28 28 28 28 28 28 28 28 28 1 28 1 1 28 1 1 1 1 1 
1 1 1 1 1 1 1 1 28 28 28 28 28 28 1 28 28 28 28 28 28 28 28 28 28 28 28 28 28 28 1 28 1 1 1 1 1 1 1 1 
1 1 1 1 1 1 1 1 28 28 28 28 28 28 1 28 28 28 28 28 28 28 28 28 28 28 28 28 28 28 1 28 1 1 1 1 1 1 1 1 
1 1 1 1 1 1 1 1 28 28 28 28 28 28 1 1 1 1 1 1 1 1 1 28 28 28 28 28 28 28 1 28 1 1 1 1 1 1 1 1 
1 1 1 1 1 1 1 1 28 28 1 1 1 1 1 1 1 1 1 28 28 28 1 28 1 28 28 28 1 28 1 28 1 1 1 1 1 1 1 1 
1 1 1 1 1 1 1 1 28 1 1 1 1 1 1 1 1 1 1 1 1 28 1 28 1 28 28 28 1 28 1 28 1 1 1 1 1 1 1 1 
1 1 1 1 1 1 1 1 1 1 1 1 1 1 1 1 1 1 1 1 1 28 1 28 1 28 28 28 1 28 1 28 1 1 1 1 1 1 1 1 
1 1 1 1 1 1 1 1 1 1 1 1 1 1 1 1 1 1 1 1 1 28 1 1 28 28 28 28 28 1 1 1 1 1 1 1 1 1 1 20 
1 1 1 1 1 1 1 1 1 1 1 1 1 1 1 1 1 1 1 1 1 28 1 1 1 28 28 28 1 1 1 1 1 1 1 1 1 1 20 1 
1 1 1 1 1 1 1 1 1 1 1 1 1 1 1 1 1 1 1 1 1 1 1 1 1 28 28 28 1 1 1 1 1 28 1 1 1 20 1 1 
1 1 1 1 1 1 1 1 1 1 1 1 1 1 1 1 1 1 0 1 1 28 28 28 28 28 28 28 28 28 1 28 1 28 1 1 1 20 1 1 
1 1 1 1 1 1 1 1 1 1 1 1 1 1 1 1 1 1 28 28 28 28 28 28 28 28 28 28 28 28 1 28 1 1 1 1 1 20 1 1 
1 1 1 1 1 1 1 1 1 1 1 1 1 1 1 1 1 1 28 28 28 28 28 28 28 28 28 28 28 28 1 28 1 1 28 1 1 20 1 1 
1 1 1 1 1 1 1 1 1 1 1 1 1 1 1 1 1 1 1 28 28 28 28 28 28 28 28 28 28 28 1 28 1 1 28 1 1 20 1 1 
1 1 1 1 1 1 1 1 1 1 1 1 1 1 1 1 1 1 1 1 28 28 28 28 28 28 28 28 28 28 1 28 1 1 28 1 1 1 1 1 
1 1 1 1 1 1 1 1 1 1 1 1 1 1 1 1 1 1 1 1 1 1 1 1 1 1 1 1 1 1 1 28 1 1 1 1 1 1 1 1 
1 1 1 1 1 1 1 1 1 1 1 1 1 1 1 0 1 1 1 1 1 1 1 1 1 1 1 28 28 28 28 28 1 1 1 1 1 1 1 1 
1 1 1 1 1 1 1 1 1 1 1 1 1 1 1 1 1 0 1 1 1 1 1 1 1 1 1 1 1 28 28 28 1 1 1 1 1 1 1 1 
1 1 1 1 1 1 1 1 1 1 1 1 1 1 1 1 1 1 1 1 1 1 28 1 1 1 1 1 1 1 28 28 1 1 1 1 1 1 1 1 
1 1 1 1 1 1 1 1 1 1 1 1 1 1 1 1 1 1 1 1 1 1 1 1 1 0 1 1 1 1 1 28 1 1 1 1 1 1 1 1 
1 1 1 1 1 1 1 1 1 1 1 1 1 1 1 1 1 1 1 1 1 1 1 1 1 1 1 1 1 1 1 1 1 1 1 1 1 1 1 1 
1 1 1 1 1 1 1 20 1 1 1 1 1 1 1 1 1 1 1 1 1 1 1 1 1 1 1 1 1 1 1 1 20 1 1 1 1 1 1 1 
1 1 1 1 1 1 1 20 1 1 1 1 1 1 1 1 1 1 1 1 1 1 1 1 1 1 1 1 1 1 1 1 20 1 1 1 1 1 1 1 
1 1 1 1 1 1 1 20 20 20 1 1 1 1 1 1 1 1 1 1 1 1 1 1 1 1 1 1 1 1 1 1 1 1 1 1 1 1 1 1 
1 1 1 1 1 1 1 1 1 1 1 1 1 1 1 1 1 1 0 1 1 1 1 1 1 1 1 1 1 1 1 1 1 1 1 1 1 1 1 1 
1 1 1 1 1 1 1 1 1 1 1 1 1 1 1 1 1 1 20 1 1 1 1 1 1 1 1 1 1 1 1 1 1 1 1 1 1 1 1 1 
1 1 1 1 1 1 1 1 1 1 1 1 1 1 1 1 1 20 20 1 20 1 1 1 1 1 1 1 1 1 1 1 1 1 1 1 1 1 1 1 
1 1 1 1 1 1 1 1 1 1 1 1 20 20 20 20 20 20 20 20 20 20 20 20 20 1 1 1 1 1 20 1 1 1 1 1 1 1 1 1 
1 1 1 1 1 1 1 1 1 20 1 1 20 20 20 20 20 20 20 20 20 20 20 20 20 1 20 20 20 20 20 1 1 1 1 1 1 1 1 1 
1 1 1 1 1 1 1 1 1 20 1 1 20 20 20 20 20 20 20 20 20 20 20 20 20 1 1 1 1 1 1 1 1 1 1 1 1 1 1 1 
1 1 1 1 1 1 20 1 1 20 1 1 1 20 20 20 20 20 20 20 20 20 20 20 20 1 1 1 1 1 1 1 1 1 20 1 1 1 1 1 
1 1 1 1 1 1 1 1 1 1 1 1 1 20 20 20 20 20 20 20 20 20 20 20 20 1 1 1 1 1 1 1 20 1 1 1 1 1 1 1 
1 1 1 1 1 20 1 1 20 1 20 1 1 20 20 20 20 20 20 20 20 20 20 20 1 1 20 20 20 20 1 1 1 1 1 1 1 1 1 1 
20 1 1 1 1 20 1 1 1 1 1 1 1 20 20 20 20 20 20 20 20 20 20 20 1 20 20 20 20 20 1 1 1 1 1 1 1 1 1 1 
1 1 1 1 1 1 1 1 1 1 1 1 1 20 20 20 1 1 1 20 20 1 1 1 1 20 20 20 20 1 1 1 1 1 1 1 1 1 1 1 
1 1 1 1 1 1 1 1 1 1 1 1 1 1 20 20 1 20 21 20 20 20 20 20 20 20 20 20 20 1 1 1 1 1 1 1 1 1 1 1 
1 1 1 1 1 1 1 20 1 1 1 1 20 1 20 20 1 20 20 20 20 20 20 20 20 20 20 20 20 1 1 1 1 1 1 1 1 1 1 1 
1 1 1 1 1 1 1 1 1 1 1 1 20 1 20 1 1 1 1 0 0 1 1 1 20 20 20 20 20 1 1 1 20 1 1 1 1 1 1 1 
1 1 1 1 1 1 20 1 1 1 1 1 20 1 1 1 1 1 12 12 12 12 12 1 1 1 1 20 20 1 1 1 20 1 1 1 1 1 1 1 
4 1 1 1 1 1 1 1 1 1 1 1 1 20 20 1 1 4 4 4 4 4 4 4 4 4 1 1 20 1 1 1 20 1 1 1 1 1 1 12 
4 4 1 1 1 1 1 1 1 1 1 20 1 1 1 1 4 4 4 4 4 4 4 4 4 4 4 1 1 1 1 1 1 1 1 1 1 1 1 12 
4 4 1 1 1 1 1 1 1 1 1 1 1 1 1 4 4 4 4 4 4 4 4 4 4 4 4 1 1 1 1 1 1 20 1 1 1 1 1 12 
4 4 1 4 1 1 1 1 1 1 1 1 1 1 1 4 4 4 4 4 4 4 4 4 4 4 4 1 1 1 1 1 1 20 1 1 1 1 1 12 
4 4 1 1 1 1 1 1 1 1 1 1 1 1 1 4 4 4 4 4 4 4 4 4 4 4 4 1 1 1 1 1 1 20 1 1 1 1 1 12 
4 4 4 1 1 1 1 1 1 20 1 1 1 1 1 4 4 4 4 4 4 4 4 4 4 4 4 1 1 1 1 1 20 20 1 1 1 1 1 12 
4 4 4 1 1 1 1 1 1 20 1 1 1 1 1 4 4 4 4 4 4 4 4 4 4 4 4 1 1 1 1 1 20 1 1 1 1 1 1 12 
4 4 4 1 1 1 4 1 1 1 1 1 1 1 1 4 4 4 4 4 4 4 4 4 4 4 4 1 1 1 1 1 1 1 20 1 1 1 1 12 
4 4 4 1 1 1 1 1 20 20 20 1 1 1 1 4 4 4 4 4 4 4 4 4 4 4 4 1 1 1 1 20 20 20 20 1 1 1 1 12 
1 1 4 1 1 1 1 1 20 20 20 1 1 1 1 4 4 4 4 4 4 4 4 4 4 4 4 1 1 1 1 1 1 20 20 1 1 1 1 12 
1 1 4 1 1 1 1 1 1 1 1 1 1 1 1 4 4 4 4 4 4 4 4 4 4 4 4 1 1 1 1 20 1 1 1 1 1 1 1 12 
4 4 1 1 1 1 1 1 1 1 1 1 1 1 1 4 4 4 4 4 4 4 4 4 4 4 4 1 1 20 1 1 1 1 1 1 1 1 1 12 
4 4 1 1 1 1 1 1 20 20 20 1 1 1 1 4 4 4 4 4 4 4 4 4 4 4 4 1 1 1 1 1 20 20 20 1 1 1 1 12 
4 4 4 4 1 1 20 1 1 1 1 1 20 1 1 1 1 4 4 4 4 4 4 4 4 4 4 1 1 1 20 1 1 1 1 1 20 1 1 12 
4 4 4 4 4 1 1 1 20 20 20 20 1 1 4 1 1 4 4 4 4 4 4 4 4 4 5 5 4 1 1 20 20 1 1 1 1 1 12 12 
4 4 4 4 4 4 4 1 1 1 1 1 1 4 4 1 1 4 4 4 4 4 4 4 4 4 1 1 4 4 1 1 1 1 4 4 4 4 4 4 
4 4 4 4 4 4 4 4 1 1 4 4 4 4 4 1 1 4 4 4 4 4 4 4 4 4 4 1 1 5 4 4 4 4 4 4 4 4 4 4 
4 4 4 4 4 4 4 4 1 1 1 1 1 1 1 1 4 4 4 4 4 4 4 4 4 4 4 1 0 5 4 4 4 4 4 4 4 4 4 4 
4 4 4 4 4 4 4 4 4 4 1 1 1 1 1 1 4 4 4 4 4 4 4 4 4 4 4 1 1 5 4 4 4 4 4 4 4 4 4 4 
1 1 4 4 4 4 4 4 4 4 4 4 4 4 4 4 4 4 4 4 4 4 4 4 4 4 4 4 4 5 5 4 4 4 4 4 4 4 4 4 
1 1 4 4 4 4 4 4 4 4 4 4 4 4 4 4 4 4 4 1 1 5 4 4 4 4 4 1 1 1 1 4 4 4 4 4 4 4 4 4 
4 1 1 1 1 5 5 4 4 1 1 4 4 4 4 4 4 4 4 1 0 5 4 4 4 1 1 1 1 4 4 4 4 4 4 4 4 4 4 4 
4 1 1 1 1 1 1 1 1 1 1 1 1 1 1 1 1 1 1 1 1 5 5 1 5 1 1 4 4 4 4 4 4 4 4 4 4 4 4 4 
4 4 4 4 4 4 4 1 1 4 4 1 1 1 1 1 1 1 1 4 4 4 1 1 1 4 4 4 4 4 4 4 4 4 4 4 4 4 4 4 
