Connections;
Exits;FALLARBOR TOWN (5.4); (25.60); (25.25);
1 1 1 1 1 1 1 1 1 1 1 1 1 1 
1 1 1 1 1 13 1 1 1 13 1 1 1 1 
0 0 0 1 0 12 0 0 1 12 0 0 1 12 
1 1 1 1 1 1 1 1 1 1 1 1 1 12 
12 12 12 12 0 12 12 12 1 0 12 12 1 12 
12 12 12 12 12 12 12 12 12 12 12 12 12 0 
1 16 0 12 12 12 12 12 12 12 12 12 12 12 
12 12 12 12 12 12 12 12 12 12 12 12 12 12 
12 12 12 12 12 12 12 12 12 12 12 12 12 12 
13 12 12 12 12 1 1 12 12 1 1 12 12 13 
