connections=[
		],
events={
	{
		exits:[FALLARBOR TOWN (0.13),FALLARBOR TOWN (0.13),		]},
	{
		NPCs:[
			{is_trainer:0,b1:8,b2:0,sprite:44},
			{is_trainer:0,b1:5,b2:0,sprite:55},
			{is_trainer:0,b1:3,b2:0,sprite:11},
			{is_trainer:0,b1:8,b2:0,sprite:47},
			{is_trainer:0,b1:10,b2:0,sprite:219},
		]},
	{
		signs:[
			{x:4,y:5},
		]},
	{
		triggers:[
		]},

},
[
	[1, 1, 13, 13, 13, 13, 13, 13, 13, 13, 13, 1, 1, ],
	[1, 1, 1, 1, 1, 1, 0, 1, 1, 1, 1, 1, 1, ],
	[1, 12, 1, 1, 12, 12, 12, 12, 12, 1, 1, 1, 1, ],
	[1, 12, 1, 0, 12, 12, 12, 12, 12, 0, 1, 13, 1, ],
	[1, 12, 1, 1, 1, 1, 12, 1, 1, 1, 1, 13, 1, ],
	[12, 12, 1, 1, 1, 1, 12, 1, 1, 1, 1, 12, 12, ],
	[12, 12, 12, 12, 12, 12, 12, 12, 12, 12, 12, 12, 12, ],
	[12, 12, 12, 12, 12, 12, 12, 12, 12, 12, 12, 12, 12, ],
	[1, 12, 12, 12, 12, 12, 12, 12, 12, 12, 12, 12, 1, ],
	[1, 1, 12, 12, 12, 12, 0, 0, 12, 12, 12, 1, 1, ],
]
