connections=[
			{'left':'ROUTE 114 (0.29)'},
			{'right':'ROUTE 113 (0.28)'},
		],
events={
	
		'exits':[{'name':'FALLARBOR TOWN (5.0)','x':15,'y':15},{'name':'FALLARBOR TOWN (5.1)','x':8,'y':7},{'name':'FALLARBOR TOWN (5.4)','x':14,'y':7},{'name':'FALLARBOR TOWN (5.6)','x':6,'y':17},{'name':'FALLARBOR TOWN (5.7)','x':1,'y':6},		],
	
		'NPCs':[
			{'is_trainer':0,'b1':8,'b2':0,'sprite':'8','x':8,'y':11},
			{'is_trainer':0,'b1':5,'b2':0,'sprite':'21','x':11,'y':9},
			{'is_trainer':0,'b1':3,'b2':0,'sprite':'48','x':11,'y':15},
			{'is_trainer':0,'b1':1,'b2':0,'sprite':'214','x':8,'y':12},
		],
	
		'signs':[
			{'x':16,'y':15},
			{'x':15,'y':7},
			{'x':6,'y':8},
			{'x':16,'y':7},
			{'x':10,'y':11},
			{'x':17,'y':15},
			{'x':3,'y':7},
			{'x':2,'y':15},
		],
	
		'triggers':[
		],

},
partial_map=[
	[0, 0, 0, 0, 0, 0, 0, 0, 0, 0, 0, 0, 0, 0, 1, 1, 1, 1, 1, 1, ],
	[1, 1, 1, 1, 1, 1, 1, 1, 1, 1, 1, 1, 1, 1, 0, 0, 0, 0, 0, 0, ],
	[1, 1, 1, 1, 1, 1, 1, 1, 1, 1, 1, 1, 1, 1, 1, 1, 1, 1, 1, 1, ],
	[1, 1, 1, 1, 1, 1, 1, 1, 1, 1, 1, 1, 1, 1, 1, 1, 1, 1, 1, 1, ],
	[1, 1, 1, 1, 13, 13, 1, 1, 1, 1, 1, 1, 1, 1, 1, 1, 1, 1, 1, 1, ],
	[1, 1, 1, 1, 12, 12, 1, 1, 1, 1, 1, 12, 12, 1, 1, 1, 1, 1, 1, 1, ],
	[1, 1, 1, 1, 12, 13, 1, 1, 1, 1, 1, 13, 12, 1, 1, 1, 1, 12, 12, 12, ],
	[12, 12, 12, 1, 12, 13, 1, 1, 1, 1, 1, 13, 12, 1, 1, 1, 1, 12, 12, 12, ],
	[12, 12, 12, 12, 12, 12, 1, 12, 12, 12, 12, 12, 12, 12, 12, 12, 12, 12, 12, 12, ],
	[12, 12, 12, 12, 12, 12, 12, 12, 12, 12, 12, 12, 12, 12, 12, 12, 12, 12, 12, 12, ],
	[12, 12, 12, 12, 12, 12, 12, 12, 12, 12, 12, 12, 12, 12, 12, 12, 12, 12, 12, 12, ],
	[12, 12, 12, 12, 12, 12, 12, 12, 12, 12, 1, 12, 12, 12, 12, 12, 12, 12, 12, 12, ],
	[12, 12, 12, 12, 12, 12, 12, 12, 12, 12, 12, 12, 12, 12, 12, 12, 12, 12, 12, 12, ],
	[12, 12, 12, 12, 12, 12, 12, 12, 12, 12, 12, 12, 12, 12, 1, 1, 1, 1, 12, 12, ],
	[12, 12, 12, 12, 12, 12, 12, 12, 12, 12, 12, 12, 12, 12, 1, 1, 1, 1, 12, 12, ],
	[12, 12, 12, 12, 12, 1, 1, 1, 1, 12, 12, 12, 12, 12, 1, 1, 1, 1, 13, 13, ],
	[12, 12, 12, 12, 12, 1, 1, 1, 1, 12, 12, 12, 12, 12, 12, 12, 12, 12, 12, 1, ],
	[12, 12, 12, 12, 12, 1, 1, 1, 1, 12, 12, 12, 12, 12, 12, 12, 12, 12, 13, 13, ],
	[1, 12, 12, 12, 12, 12, 12, 12, 12, 12, 12, 12, 12, 12, 12, 12, 12, 13, 1, 1, ],
	[1, 1, 1, 1, 12, 12, 12, 12, 12, 12, 12, 12, 12, 12, 1, 13, 1, 1, 13, 13, ],
]
