Connections;
Exits;FORTREE CITY (0.4);FORTREE CITY (0.4);
1 1 1 1 1 1 1 1 
1 1 1 1 1 1 1 1 
12 13 13 1 1 12 12 12 
12 12 12 1 1 12 12 12 
12 12 12 12 12 12 12 12 
13 12 12 0 0 12 12 13 
