connections=[
		],
events={
	{
		exits:[FORTREE CITY (12.2), (25.60), (25.25),		]},
	{
		NPCs:[
			{is_trainer:0,b1:8,b2:0,sprite:85},
			{is_trainer:0,b1:8,b2:0,sprite:85},
			{is_trainer:0,b1:8,b2:0,sprite:85},
			{is_trainer:0,b1:8,b2:0,sprite:223},
		]},
	{
		signs:[
		]},
	{
		triggers:[
		]},

},
[
	[1, 1, 1, 1, 1, 1, 1, 1, 1, 1, 1, 1, 1, 1, ],
	[1, 1, 1, 1, 1, 13, 1, 1, 1, 13, 1, 1, 1, 1, ],
	[0, 0, 0, 1, 0, 12, 0, 0, 1, 12, 0, 0, 1, 12, ],
	[1, 1, 1, 1, 1, 1, 1, 1, 1, 1, 1, 1, 1, 12, ],
	[12, 12, 12, 12, 0, 12, 12, 12, 1, 0, 12, 12, 1, 12, ],
	[12, 12, 12, 12, 12, 12, 12, 12, 12, 12, 12, 12, 12, 0, ],
	[1, 16, 0, 12, 12, 12, 12, 12, 12, 12, 12, 12, 12, 12, ],
	[12, 12, 12, 12, 12, 12, 12, 12, 12, 12, 12, 12, 12, 12, ],
	[12, 12, 12, 12, 12, 12, 12, 12, 12, 12, 12, 12, 12, 12, ],
	[13, 12, 12, 12, 12, 1, 1, 12, 12, 1, 1, 12, 12, 13, ],
]
