Connections;
Exits;GRANITE CAVE (24.7);
1 1 1 1 1 1 1 1 1 1 1 1 1 1 1 
1 1 1 1 1 1 1 1 1 1 1 1 1 1 1 
1 1 1 1 1 1 1 1 1 1 1 1 1 1 1 
1 1 1 1 1 1 1 12 1 1 1 1 1 1 1 
1 1 1 1 1 12 12 12 12 1 1 1 1 1 1 
1 1 1 1 1 1 12 12 12 1 1 1 1 1 1 
1 1 1 1 12 12 12 12 12 1 1 1 1 1 1 
1 1 1 1 12 12 12 12 12 12 12 1 1 1 1 
1 1 1 1 12 12 12 12 12 12 1 1 1 1 1 
1 1 1 1 1 1 12 12 12 12 12 1 1 1 1 
1 1 1 1 1 1 12 1 12 12 12 1 1 1 1 
1 1 1 1 1 1 1 1 1 1 1 1 1 1 1 
1 1 1 1 1 1 1 1 1 1 1 1 1 1 1 
1 1 1 1 1 1 1 1 1 1 1 1 1 1 1 
