Connections;
Exits;ROUTE 112 (0.27);ROUTE 112 (0.27);MT. CHIMNEY (24.12);MT. CHIMNEY (24.12);MAGMA HIDEOUT (24.86);
1 1 1 1 1 1 1 1 1 1 1 1 13 13 13 13 1 1 1 1 1 1 1 1 1 1 1 1 1 1 
1 1 1 1 1 1 1 1 1 1 1 1 13 13 13 13 1 1 1 1 1 1 1 1 1 1 1 1 1 1 
1 1 1 1 1 1 1 1 1 1 1 1 13 13 13 13 1 1 1 1 12 12 1 1 1 12 12 1 1 1 
1 1 1 1 1 1 1 1 1 1 1 1 13 13 13 13 1 1 1 1 12 1 1 12 1 1 1 1 1 1 
1 1 1 1 1 1 1 1 1 1 1 1 1 13 13 1 1 1 1 1 1 1 12 12 1 1 1 12 1 1 
1 1 1 1 1 1 1 1 1 1 1 12 1 12 12 1 12 1 1 1 1 1 1 1 1 1 1 1 1 1 
1 1 1 1 1 1 1 1 1 1 1 1 1 12 12 1 1 1 1 1 1 1 1 1 1 1 1 1 1 1 
1 12 1 1 1 1 1 1 1 1 12 12 1 12 12 1 12 12 12 12 1 1 1 1 1 1 1 1 1 1 
1 1 1 1 1 1 1 1 1 1 12 12 12 12 12 12 12 12 12 12 1 1 1 1 1 1 1 1 1 12 
1 1 1 1 1 1 1 1 1 1 1 1 1 1 1 1 1 1 12 1 1 1 1 1 1 1 1 1 1 1 
1 1 1 1 1 1 1 1 12 12 1 12 12 12 12 12 12 1 12 12 12 12 1 1 12 12 1 1 1 1 
1 1 1 1 1 1 1 1 12 12 1 1 1 1 1 1 1 1 12 12 1 12 1 1 1 1 1 1 1 12 
12 1 1 1 1 1 1 1 12 12 12 12 12 12 12 12 12 12 12 12 1 12 12 1 1 1 1 12 1 1 
1 1 1 1 12 1 1 1 1 1 1 1 1 12 12 1 1 1 1 1 1 12 12 1 12 12 1 1 1 1 
1 1 1 1 1 1 1 1 1 1 1 1 1 1 1 1 1 1 1 1 1 12 1 1 12 12 1 1 1 1 
1 1 12 12 1 1 1 1 1 1 12 12 12 12 12 12 12 12 1 1 12 12 12 1 1 1 1 1 1 1 
1 1 1 1 1 1 1 1 1 1 1 1 1 1 1 1 1 1 1 1 12 12 12 1 12 12 12 12 1 1 
1 1 1 1 1 1 1 1 1 1 12 12 12 12 12 1 0 1 12 12 12 12 12 1 1 1 12 12 1 1 
1 1 1 1 1 1 1 12 12 1 1 1 1 12 12 1 0 1 1 1 1 1 12 1 1 1 1 1 1 1 
1 1 1 1 1 1 1 12 12 12 12 12 12 12 12 12 12 12 12 12 12 12 12 1 1 1 1 12 12 1 
1 12 1 1 1 12 1 1 12 12 12 12 12 12 12 12 12 12 12 12 12 12 12 1 1 1 1 12 12 1 
1 12 12 1 1 12 1 1 12 12 12 12 12 12 12 12 12 12 12 12 1 12 12 1 1 12 1 12 12 1 
1 12 12 1 1 1 1 1 1 1 1 12 12 12 12 12 12 12 12 12 1 12 12 1 12 12 1 12 12 1 
1 1 1 1 1 1 1 1 12 12 1 1 1 1 1 1 1 1 1 1 1 12 12 1 1 1 1 12 12 1 
1 1 1 1 1 13 13 1 12 12 12 12 1 1 12 12 12 12 12 1 12 12 12 12 1 1 1 1 1 1 
1 13 13 1 1 1 1 1 12 12 12 12 1 1 12 12 12 12 12 1 12 12 1 1 1 1 0 0 0 1 
12 1 1 1 1 1 1 1 1 1 1 1 1 1 1 1 1 1 1 1 12 12 1 1 1 1 12 12 12 1 
12 1 12 12 1 1 1 1 12 12 12 12 1 1 12 12 12 12 12 1 1 12 1 1 1 1 1 1 12 1 
12 1 12 12 1 1 1 1 1 1 1 1 1 1 1 1 1 1 1 1 12 12 1 12 12 12 1 1 1 1 
1 1 1 1 12 12 1 12 1 12 12 12 12 12 12 12 12 12 12 12 12 12 1 12 12 12 1 1 1 12 
1 12 1 1 12 12 1 12 1 12 1 1 1 1 1 1 1 1 1 1 1 12 1 12 1 1 1 1 1 12 
13 1 1 1 1 1 1 12 12 12 12 12 12 12 12 12 12 1 1 12 12 12 1 1 1 1 12 1 1 12 
1 1 1 1 1 1 1 1 1 12 1 1 1 1 1 1 1 12 12 12 12 12 12 1 1 1 1 1 12 12 
1 1 1 1 1 1 1 12 12 12 12 12 12 12 12 1 1 1 1 1 1 1 1 1 1 1 1 1 1 1 
1 1 1 1 1 1 1 12 12 12 12 12 12 12 12 12 12 12 12 12 12 12 12 1 1 1 1 1 1 1 
1 1 13 1 1 1 1 1 1 12 12 12 12 12 12 12 12 12 12 12 12 1 1 1 1 1 1 1 1 1 
1 1 1 1 1 1 1 1 1 1 1 1 1 12 12 12 12 1 1 1 1 1 1 1 1 1 1 1 1 1 
1 1 1 1 1 1 1 1 12 12 12 12 1 1 12 12 1 1 12 12 12 12 1 1 1 1 1 1 1 1 
1 1 1 1 1 1 1 1 1 1 1 1 12 12 12 12 12 12 1 1 1 1 1 1 1 1 1 1 1 1 
1 1 1 1 1 1 1 1 1 1 1 1 12 12 12 12 12 12 1 1 1 1 1 1 1 1 1 1 1 1 
1 1 1 1 1 1 1 1 1 1 1 1 1 1 12 12 1 1 1 1 1 1 1 1 1 1 1 1 1 1 
1 1 1 1 1 1 1 1 1 1 1 1 1 1 13 13 1 1 1 1 1 1 1 1 1 1 1 1 1 1 
1 1 1 1 1 1 1 1 1 1 1 1 1 1 13 13 1 1 1 1 1 1 1 1 1 1 1 1 1 1 
1 1 1 1 1 1 1 1 1 1 1 1 1 1 13 13 1 1 1 1 1 1 1 1 1 1 1 1 1 1 
1 1 1 1 1 1 1 1 1 1 1 1 1 1 13 13 1 1 1 1 1 1 1 1 1 1 1 1 1 1 
1 1 1 1 1 1 1 1 1 1 1 1 1 1 13 13 1 1 1 1 1 1 1 1 1 1 1 1 1 1 
