Connections;
Exits;LAVARIDGE TOWN (0.12);LAVARIDGE TOWN (0.12);LAVARIDGE TOWN (4.6);LAVARIDGE TOWN (0.12);
1 1 1 1 1 1 1 1 1 1 1 1 1 1 
1 1 0 1 1 1 1 1 1 1 1 1 1 1 
12 12 12 12 1 1 1 12 1 1 12 12 12 12 
12 12 12 12 1 1 1 1 1 1 12 12 12 12 
12 12 12 12 12 12 12 12 12 12 12 12 12 12 
12 12 12 12 12 12 12 12 12 12 12 12 12 12 
13 16 0 12 12 12 12 12 12 12 12 1 1 12 
12 12 12 12 12 12 12 12 12 12 12 1 1 12 
1 12 12 12 12 12 12 12 12 12 12 12 12 1 
