Connections;right:ROUTE 112 (0.27);
Exits;LAVARIDGE TOWN (4.0);LAVARIDGE TOWN (4.1);LAVARIDGE TOWN (4.4);LAVARIDGE TOWN (4.5);LAVARIDGE TOWN (4.3);LAVARIDGE TOWN (4.5);
1 1 1 1 1 1 1 1 1 1 1 1 1 1 1 1 1 1 13 13 
1 1 1 1 1 12 12 12 12 12 1 1 1 1 1 1 1 1 1 1 
1 1 1 1 1 1 12 1 1 12 1 1 1 1 1 1 1 1 1 13 
1 1 1 12 12 12 12 1 1 1 1 1 1 1 1 1 1 1 1 1 
1 1 1 12 12 12 12 1 1 1 1 1 12 12 1 1 1 1 13 13 
1 1 1 12 12 12 12 1 1 1 1 1 13 13 1 1 1 1 13 13 
1 1 1 1 1 1 1 1 1 1 1 1 13 13 12 12 12 12 13 13 
1 1 12 12 12 12 12 12 12 12 12 12 12 12 12 12 12 12 12 12 
1 1 12 12 12 12 12 12 12 12 12 12 12 1 12 12 12 12 12 12 
1 1 0 16 0 16 0 12 12 12 12 12 12 12 12 12 12 12 12 12 
1 1 12 0 12 0 12 12 12 12 12 12 12 12 12 12 12 12 12 12 
1 1 12 12 12 12 12 12 12 12 12 12 12 12 12 12 12 12 12 12 
1 1 1 1 1 1 1 1 12 12 12 12 12 12 12 12 12 12 12 12 
1 1 1 1 1 1 1 1 12 12 12 1 1 1 1 1 1 1 1 12 
1 1 1 1 1 1 1 1 12 12 12 1 1 1 1 1 1 1 1 13 
1 1 12 12 1 1 1 1 12 12 12 1 1 1 1 1 1 1 1 13 
1 1 12 12 12 12 12 12 12 12 12 12 12 12 13 12 12 12 12 13 
1 1 1 12 12 12 12 12 12 12 12 12 12 12 12 12 12 12 13 13 
1 1 1 1 12 12 12 12 12 12 12 12 12 12 12 12 12 12 13 13 
1 1 1 1 1 1 1 1 1 1 1 1 1 1 1 1 1 1 1 1 
