connections=[
		],
events={
	{
		exits:[LAVARIDGE TOWN (0.12),LAVARIDGE TOWN (0.12),		]},
	{
		NPCs:[
			{is_trainer:0,b1:8,b2:0,sprite:20},
			{is_trainer:0,b1:1,b2:0,sprite:29},
			{is_trainer:0,b1:5,b2:0,sprite:21},
		]},
	{
		signs:[
		]},
	{
		triggers:[
		]},

},
[
	[1, 1, 1, 1, 1, 1, 1, 1, 1, 1, 1, ],
	[1, 1, 1, 1, 1, 1, 1, 1, 1, 1, 1, ],
	[12, 12, 12, 12, 12, 1, 12, 12, 12, 12, 12, ],
	[1, 1, 1, 1, 1, 1, 12, 12, 12, 12, 1, ],
	[12, 12, 12, 12, 12, 12, 12, 12, 12, 12, 1, ],
	[12, 12, 12, 12, 12, 12, 12, 12, 12, 12, 1, ],
	[12, 12, 12, 12, 12, 12, 12, 12, 12, 12, 12, ],
	[1, 1, 12, 0, 0, 12, 12, 12, 12, 1, 1, ],
]
