Connections;
Exits;LAVARIDGE TOWN (0.12);LAVARIDGE TOWN (0.12);
1 1 1 1 1 1 1 1 1 1 
1 1 1 1 1 1 1 1 1 1 
12 12 12 12 12 12 12 12 12 12 
12 12 12 12 1 1 12 12 12 12 
12 12 12 12 1 1 12 12 12 12 
12 12 12 12 12 12 12 12 12 12 
12 12 12 12 12 12 12 12 12 12 
12 12 12 0 0 12 12 12 12 12 
