Connections;
Exits;LAVARIDGE TOWN (4.1);LAVARIDGE TOWN (4.1);LAVARIDGE TOWN (4.1);LAVARIDGE TOWN (4.1);LAVARIDGE TOWN (4.1);LAVARIDGE TOWN (4.1);LAVARIDGE TOWN (4.1);LAVARIDGE TOWN (4.1);LAVARIDGE TOWN (4.1);LAVARIDGE TOWN (4.1);LAVARIDGE TOWN (4.1);LAVARIDGE TOWN (4.1);LAVARIDGE TOWN (4.1);LAVARIDGE TOWN (4.1);LAVARIDGE TOWN (4.1);LAVARIDGE TOWN (4.1);LAVARIDGE TOWN (4.1);LAVARIDGE TOWN (4.1);LAVARIDGE TOWN (4.1);LAVARIDGE TOWN (4.1);LAVARIDGE TOWN (4.1);LAVARIDGE TOWN (4.1);LAVARIDGE TOWN (4.1);LAVARIDGE TOWN (4.1);
1 1 1 1 1 1 1 1 1 1 1 1 1 1 1 1 1 
1 1 1 1 1 1 1 1 1 1 1 1 1 1 1 1 1 
12 12 12 12 1 12 12 0 12 12 1 12 12 12 12 12 12 
12 12 0 12 12 12 12 12 12 12 12 12 0 12 12 12 12 
1 1 1 1 1 1 1 1 1 1 1 1 1 1 1 1 1 
1 1 1 1 1 1 1 1 1 1 1 1 1 1 1 1 1 
0 12 12 0 1 12 12 1 12 1 12 12 12 1 12 12 12 
12 12 12 12 1 12 12 1 12 1 12 12 12 1 12 12 12 
12 12 12 12 1 12 12 1 12 1 12 12 12 1 12 12 12 
12 12 12 12 1 12 12 1 0 1 12 12 12 1 12 12 12 
0 12 12 12 1 12 12 1 12 1 1 1 1 1 1 1 1 
12 12 12 12 1 1 1 1 12 1 12 12 12 1 12 12 12 
1 1 1 1 1 12 12 1 12 1 12 12 0 1 12 12 12 
12 12 12 12 1 12 12 1 12 1 12 12 12 1 12 12 12 
12 0 12 12 1 0 12 1 12 1 12 12 12 1 12 12 12 
12 12 12 12 1 12 12 1 12 1 1 1 1 1 12 12 12 
12 12 12 12 0 12 12 12 12 1 12 12 12 1 12 12 12 
0 12 12 12 12 12 12 12 12 1 12 12 12 0 12 12 12 
12 12 12 12 0 12 12 12 12 1 0 12 12 12 12 12 12 
