connections=[
		],
events={
	{
		exits:[LILYCOVE CITY (0.5),LILYCOVE CITY (0.5),LILYCOVE CITY (13.17),LILYCOVE CITY (13.22),		]},
	{
		NPCs:[
			{is_trainer:0,b1:8,b2:0,sprite:45},
			{is_trainer:0,b1:8,b2:0,sprite:45},
			{is_trainer:0,b1:2,b2:0,sprite:18},
			{is_trainer:0,b1:2,b2:0,sprite:12},
			{is_trainer:0,b1:1,b2:0,sprite:25},
			{is_trainer:0,b1:1,b2:0,sprite:210},
		]},
	{
		signs:[
			{x:0,y:8},
		]},
	{
		triggers:[
		]},

},
[
	[1, 1, 1, 1, 1, 1, 1, 1, 1, 1, 1, 1, 1, 1, 1, 1, 1, 1, ],
	[1, 1, 1, 1, 1, 1, 1, 1, 1, 1, 1, 1, 1, 1, 1, 1, 0, 1, ],
	[12, 12, 12, 12, 12, 12, 1, 12, 12, 12, 12, 1, 12, 12, 12, 12, 12, 12, ],
	[12, 12, 12, 12, 12, 12, 1, 1, 1, 1, 1, 1, 12, 12, 12, 12, 12, 12, ],
	[12, 12, 12, 12, 12, 12, 12, 12, 12, 12, 12, 12, 12, 12, 12, 12, 12, 12, ],
	[1, 1, 0, 12, 12, 12, 12, 12, 12, 12, 12, 12, 12, 12, 12, 12, 12, 12, ],
	[12, 12, 12, 12, 12, 12, 12, 12, 12, 12, 12, 12, 12, 12, 12, 12, 12, 12, ],
	[1, 1, 12, 12, 12, 12, 12, 12, 0, 0, 12, 12, 12, 12, 1, 12, 1, 1, ],
]
