Connections;
Exits;LILYCOVE CITY (13.19);LILYCOVE CITY (13.22);LILYCOVE CITY (13.21);
1 1 1 1 1 1 1 1 1 1 1 13 1 1 1 1 1 1 
1 1 1 1 1 1 1 1 1 1 1 13 1 0 1 1 0 1 
12 12 12 12 12 1 12 12 12 12 12 1 12 12 12 12 12 12 
12 12 12 12 12 1 1 1 1 1 1 1 12 12 12 12 12 12 
12 12 1 1 12 12 12 12 12 12 12 12 12 12 12 12 12 12 
12 12 1 1 12 12 13 13 12 12 13 13 12 12 13 13 13 13 
12 12 1 1 12 12 13 13 12 12 13 13 12 12 13 12 12 12 
12 12 12 12 12 12 12 12 12 12 12 12 12 12 13 12 12 12 
