connections=[
		],
events={
	
		'exits':[{'name':'LILYCOVE CITY (13.2)','x':13,'y':1},		],
	
		'NPCs':[
			{'is_trainer':0,'b1':7,'b2':0,'sprite':'48','x':10,'y':8},
			{'is_trainer':0,'b1':2,'b2':0,'sprite':'10','x':19,'y':10},
			{'is_trainer':0,'b1':2,'b2':0,'sprite':'21','x':7,'y':3},
			{'is_trainer':0,'b1':2,'b2':0,'sprite':'15','x':14,'y':6},
		],
	
		'signs':[
			{'x':14,'y':10},
			{'x':15,'y':10},
			{'x':3,'y':6},
			{'x':2,'y':6},
			{'x':10,'y':6},
			{'x':11,'y':6},
			{'x':19,'y':6},
			{'x':18,'y':6},
			{'x':6,'y':10},
			{'x':7,'y':10},
			{'x':11,'y':2},
			{'x':15,'y':2},
		],
	
		'triggers':[
		],

},
partial_map=[
	[1, 1, 1, 1, 1, 1, 1, 1, 1, 1, 1, 1, 1, 1, 1, 1, 1, 1, 1, 1, 1, 1, ],
	[1, 1, 1, 1, 1, 1, 1, 1, 1, 1, 1, 1, 1, 0, 1, 1, 1, 1, 1, 1, 1, 1, ],
	[1, 1, 1, 1, 12, 12, 12, 12, 12, 12, 12, 1, 12, 12, 12, 1, 12, 12, 1, 1, 1, 1, ],
	[12, 12, 12, 12, 12, 12, 12, 12, 12, 12, 12, 12, 12, 12, 12, 12, 12, 12, 12, 12, 12, 12, ],
	[12, 12, 12, 12, 12, 12, 12, 12, 12, 12, 12, 12, 12, 12, 12, 12, 12, 12, 12, 12, 12, 12, ],
	[12, 1, 1, 1, 1, 12, 12, 12, 12, 1, 1, 1, 1, 12, 12, 12, 12, 1, 1, 1, 1, 12, ],
	[12, 1, 1, 1, 1, 12, 12, 12, 12, 1, 1, 1, 1, 12, 12, 12, 12, 1, 1, 1, 1, 12, ],
	[12, 12, 12, 12, 12, 12, 12, 12, 12, 12, 12, 12, 12, 12, 12, 12, 12, 12, 12, 12, 12, 12, ],
	[12, 12, 12, 12, 12, 12, 12, 12, 12, 12, 12, 12, 12, 12, 12, 12, 12, 12, 12, 12, 12, 12, ],
	[12, 12, 12, 12, 12, 1, 1, 1, 1, 12, 12, 12, 12, 1, 1, 1, 1, 12, 12, 12, 12, 12, ],
	[12, 12, 12, 12, 12, 1, 1, 1, 1, 12, 12, 12, 12, 1, 1, 1, 1, 12, 12, 12, 12, 12, ],
	[12, 12, 12, 12, 12, 12, 12, 12, 12, 12, 12, 12, 12, 12, 12, 12, 12, 12, 12, 12, 12, 12, ],
	[12, 12, 12, 12, 12, 12, 12, 12, 12, 12, 12, 12, 12, 12, 12, 12, 12, 12, 12, 12, 12, 12, ],
]
