Connections;
Exits;LILYCOVE CITY (13.16);LILYCOVE CITY (13.18);LILYCOVE CITY (13.22);
1 1 1 1 1 1 1 1 1 1 1 1 1 1 1 1 1 1 
1 1 1 1 1 1 1 1 1 1 1 1 1 0 1 1 0 1 
12 12 12 12 12 12 12 12 12 12 12 12 12 12 12 12 12 12 
12 12 12 12 12 12 12 12 12 12 12 12 12 12 12 12 12 12 
12 12 1 1 12 12 12 12 12 12 12 12 12 12 1 1 12 1 
12 12 1 1 12 12 1 1 1 1 1 1 12 12 1 1 12 12 
12 12 1 1 12 12 1 12 12 12 12 1 12 12 1 1 12 12 
12 12 12 12 12 12 1 12 12 12 12 1 12 12 12 12 12 1 
