connections=[
		],
events={
	{
		exits:[LILYCOVE CITY (0.5),LILYCOVE CITY (0.5),LILYCOVE CITY (13.5),LILYCOVE CITY (13.5),		]},
	{
		NPCs:[
			{is_trainer:0,b1:8,b2:0,sprite:85},
			{is_trainer:0,b1:8,b2:0,sprite:85},
			{is_trainer:0,b1:10,b2:0,sprite:65},
			{is_trainer:0,b1:1,b2:0,sprite:99},
			{is_trainer:0,b1:2,b2:0,sprite:44},
			{is_trainer:0,b1:2,b2:0,sprite:10},
			{is_trainer:0,b1:2,b2:0,sprite:99},
			{is_trainer:0,b1:10,b2:0,sprite:67},
			{is_trainer:0,b1:8,b2:0,sprite:7},
			{is_trainer:0,b1:9,b2:0,sprite:6},
			{is_trainer:0,b1:8,b2:0,sprite:99},
			{is_trainer:0,b1:2,b2:0,sprite:50},
			{is_trainer:0,b1:10,b2:0,sprite:17},
			{is_trainer:0,b1:3,b2:0,sprite:5},
			{is_trainer:0,b1:10,b2:0,sprite:18},
			{is_trainer:0,b1:10,b2:0,sprite:21},
			{is_trainer:0,b1:9,b2:0,sprite:8},
			{is_trainer:0,b1:8,b2:0,sprite:66},
			{is_trainer:0,b1:8,b2:0,sprite:31},
			{is_trainer:0,b1:7,b2:0,sprite:12},
			{is_trainer:0,b1:7,b2:0,sprite:115},
			{is_trainer:0,b1:7,b2:0,sprite:16},
			{is_trainer:0,b1:8,b2:0,sprite:5},
			{is_trainer:0,b1:10,b2:0,sprite:29},
			{is_trainer:0,b1:10,b2:0,sprite:12},
		]},
	{
		signs:[
			{x:23,y:5},
			{x:23,y:9},
			{x:23,y:1},
			{x:25,y:1},
			{x:27,y:1},
			{x:30,y:1},
			{x:3,y:1},
			{x:5,y:1},
			{x:7,y:1},
			{x:27,y:5},
			{x:27,y:9},
			{x:18,y:3},
		]},
	{
		triggers:[
		]},

},
[
	[1, 1, 1, 1, 1, 1, 1, 1, 1, 1, 1, 1, 1, 1, 1, 1, 1, 1, 1, 1, 1, 1, 1, 1, 1, 1, 1, 1, 1, 1, 1, ],
	[1, 1, 1, 1, 1, 1, 1, 1, 13, 0, 1, 1, 1, 1, 1, 1, 1, 1, 1, 1, 13, 0, 1, 1, 1, 1, 1, 1, 1, 1, 1, ],
	[12, 12, 12, 12, 12, 12, 12, 12, 12, 12, 12, 1, 12, 12, 12, 12, 12, 12, 1, 12, 12, 12, 12, 12, 12, 12, 12, 12, 12, 12, 12, ],
	[12, 12, 12, 12, 12, 12, 12, 12, 12, 12, 12, 1, 1, 1, 1, 1, 1, 1, 1, 12, 12, 12, 12, 12, 12, 12, 12, 12, 12, 12, 12, ],
	[12, 12, 12, 12, 12, 12, 12, 12, 12, 12, 12, 12, 12, 12, 12, 12, 12, 12, 12, 12, 12, 12, 12, 12, 12, 12, 12, 12, 12, 12, 12, ],
	[12, 12, 12, 12, 12, 12, 12, 12, 12, 12, 12, 12, 12, 12, 12, 12, 12, 12, 12, 12, 12, 12, 12, 1, 12, 12, 12, 1, 12, 12, 12, ],
	[12, 12, 12, 12, 12, 12, 12, 12, 12, 12, 12, 12, 12, 12, 12, 12, 12, 12, 12, 12, 12, 12, 12, 12, 12, 12, 12, 12, 12, 12, 12, ],
	[12, 12, 12, 12, 12, 12, 12, 12, 12, 12, 12, 12, 12, 12, 12, 12, 12, 12, 12, 12, 12, 12, 12, 12, 12, 12, 12, 12, 12, 12, 12, ],
	[12, 12, 12, 12, 12, 12, 12, 12, 12, 12, 12, 12, 12, 12, 12, 12, 12, 12, 12, 12, 12, 12, 12, 12, 12, 12, 12, 12, 12, 12, 12, ],
	[12, 12, 12, 12, 12, 12, 12, 12, 12, 12, 12, 12, 12, 12, 12, 12, 12, 12, 12, 12, 12, 12, 12, 1, 12, 12, 12, 1, 12, 12, 12, ],
	[12, 12, 12, 12, 12, 12, 12, 12, 12, 12, 12, 12, 12, 12, 12, 12, 12, 12, 12, 12, 12, 12, 12, 12, 12, 12, 12, 12, 12, 12, 12, ],
	[12, 12, 12, 12, 12, 12, 12, 12, 12, 12, 12, 12, 12, 12, 0, 0, 12, 12, 12, 12, 12, 12, 12, 12, 12, 12, 12, 12, 12, 12, 12, ],
]
