connections=[
		],
events={
	{
		exits:[LILYCOVE CITY (0.5),LILYCOVE CITY (0.5),LILYCOVE CITY (13.3),		]},
	{
		NPCs:[
			{is_trainer:0,b1:10,b2:0,sprite:45},
			{is_trainer:0,b1:8,b2:0,sprite:48},
			{is_trainer:0,b1:10,b2:0,sprite:38},
			{is_trainer:0,b1:5,b2:0,sprite:99},
			{is_trainer:0,b1:7,b2:0,sprite:5},
			{is_trainer:0,b1:7,b2:0,sprite:26},
			{is_trainer:0,b1:2,b2:0,sprite:20},
			{is_trainer:0,b1:7,b2:0,sprite:99},
			{is_trainer:0,b1:2,b2:0,sprite:17},
			{is_trainer:0,b1:2,b2:0,sprite:37},
		]},
	{
		signs:[
			{x:1,y:1},
			{x:2,y:1},
			{x:5,y:1},
			{x:6,y:1},
			{x:9,y:1},
			{x:3,y:6},
			{x:2,y:6},
			{x:15,y:12},
			{x:11,y:1},
			{x:6,y:6},
			{x:17,y:9},
			{x:19,y:1},
			{x:20,y:1},
			{x:18,y:9},
			{x:18,y:11},
			{x:16,y:9},
		]},
	{
		triggers:[
		]},

},
[
	[1, 1, 1, 1, 1, 1, 1, 1, 1, 1, 1, 1, 1, 1, 1, 1, 1, 1, 1, 1, 1, ],
	[1, 1, 1, 1, 1, 1, 1, 1, 1, 1, 1, 1, 1, 1, 1, 1, 0, 1, 1, 1, 1, ],
	[12, 12, 12, 12, 12, 12, 12, 12, 12, 12, 12, 12, 12, 1, 12, 12, 12, 12, 12, 12, 12, ],
	[12, 12, 12, 12, 12, 12, 12, 12, 12, 12, 12, 12, 12, 1, 12, 12, 12, 12, 12, 12, 12, ],
	[12, 12, 12, 12, 12, 12, 12, 12, 12, 12, 12, 12, 12, 1, 12, 12, 12, 12, 12, 12, 12, ],
	[1, 1, 1, 1, 1, 1, 1, 1, 1, 1, 12, 12, 12, 12, 12, 12, 12, 12, 12, 12, 12, ],
	[1, 1, 1, 1, 1, 1, 1, 1, 1, 1, 12, 12, 12, 12, 12, 12, 12, 12, 12, 12, 12, ],
	[12, 12, 12, 12, 12, 12, 12, 12, 12, 1, 12, 12, 12, 12, 12, 1, 1, 1, 1, 1, 12, ],
	[12, 12, 12, 12, 12, 12, 12, 12, 12, 1, 12, 12, 12, 12, 12, 1, 1, 1, 1, 1, 12, ],
	[12, 12, 12, 12, 12, 12, 12, 12, 12, 12, 12, 12, 12, 12, 12, 1, 1, 1, 1, 1, 12, ],
	[12, 1, 1, 1, 1, 1, 1, 12, 12, 12, 12, 12, 12, 12, 12, 12, 12, 12, 12, 12, 12, ],
	[12, 1, 12, 12, 12, 12, 1, 12, 12, 12, 12, 12, 12, 12, 12, 12, 12, 12, 1, 12, 12, ],
	[12, 1, 12, 12, 12, 12, 1, 12, 12, 12, 12, 12, 12, 12, 12, 1, 12, 12, 12, 12, 12, ],
	[12, 1, 1, 1, 1, 1, 1, 12, 12, 0, 0, 12, 12, 12, 12, 12, 12, 12, 12, 12, 12, ],
]
