connections=[
		],
events={
	{
		exits:[LILYCOVE CITY (0.5),LILYCOVE CITY (0.5),		]},
	{
		NPCs:[
			{is_trainer:0,b1:8,b2:0,sprite:45},
			{is_trainer:0,b1:10,b2:0,sprite:140},
			{is_trainer:0,b1:2,b2:0,sprite:49},
			{is_trainer:0,b1:8,b2:0,sprite:49},
			{is_trainer:0,b1:8,b2:0,sprite:21},
		]},
	{
		signs:[
		]},
	{
		triggers:[
		]},

},
[
	[0, 0, 0, 0, 0, 0, 0, 0, 0, 0, 0, 0, 0, 0, 0, 0, 0, 0, 0, 0, 0, 0, 0, 0, ],
	[0, 0, 0, 0, 0, 0, 0, 0, 0, 0, 0, 0, 0, 0, 0, 0, 0, 0, 0, 0, 0, 0, 0, 0, ],
	[0, 0, 0, 0, 0, 0, 0, 0, 0, 0, 0, 0, 0, 0, 0, 0, 0, 0, 0, 0, 0, 0, 0, 0, ],
	[1, 1, 1, 1, 1, 1, 1, 1, 1, 1, 1, 1, 1, 1, 1, 1, 1, 1, 1, 1, 1, 1, 1, 1, ],
	[12, 12, 12, 1, 1, 1, 1, 1, 1, 1, 1, 1, 1, 1, 1, 1, 1, 1, 1, 1, 1, 1, 1, 1, ],
	[12, 12, 12, 1, 5, 5, 5, 5, 5, 5, 5, 5, 5, 5, 5, 5, 5, 5, 5, 5, 5, 5, 5, 5, ],
	[12, 12, 12, 1, 5, 5, 5, 5, 5, 5, 5, 5, 5, 5, 5, 5, 5, 5, 5, 5, 5, 5, 5, 5, ],
	[12, 12, 12, 1, 5, 5, 5, 5, 5, 5, 5, 5, 5, 5, 5, 5, 5, 5, 5, 5, 5, 5, 5, 5, ],
	[12, 12, 12, 1, 5, 5, 5, 5, 5, 5, 5, 5, 5, 5, 5, 5, 5, 5, 5, 5, 5, 5, 5, 5, ],
	[12, 12, 12, 1, 5, 5, 5, 5, 5, 5, 5, 5, 5, 5, 5, 5, 5, 5, 5, 5, 5, 5, 5, 5, ],
	[12, 12, 12, 1, 1, 1, 1, 12, 12, 1, 1, 1, 1, 1, 1, 1, 1, 1, 13, 13, 1, 1, 1, 1, ],
	[12, 12, 12, 12, 12, 12, 12, 12, 12, 12, 12, 12, 12, 12, 12, 12, 12, 1, 13, 13, 13, 13, 13, 13, ],
	[12, 12, 12, 12, 12, 12, 12, 12, 12, 12, 12, 12, 12, 12, 12, 12, 12, 1, 13, 13, 13, 13, 13, 13, ],
	[12, 12, 12, 12, 12, 12, 12, 12, 12, 12, 12, 12, 12, 12, 12, 12, 12, 1, 13, 13, 13, 13, 13, 13, ],
	[12, 12, 12, 12, 12, 12, 12, 12, 12, 12, 12, 0, 0, 12, 12, 12, 12, 1, 13, 13, 13, 13, 13, 13, ],
]
