connections=[
		],
events={
	{
		exits:[LILYCOVE CITY (13.17),LILYCOVE CITY (13.19),LILYCOVE CITY (13.22),		]},
	{
		NPCs:[
			{is_trainer:0,b1:2,b2:0,sprite:51},
			{is_trainer:0,b1:2,b2:0,sprite:25},
			{is_trainer:0,b1:2,b2:0,sprite:34},
			{is_trainer:0,b1:8,b2:0,sprite:24},
			{is_trainer:0,b1:8,b2:0,sprite:24},
		]},
	{
		signs:[
		]},
	{
		triggers:[
		]},

},
[
	[1, 1, 1, 1, 1, 1, 1, 1, 1, 1, 1, 13, 1, 1, 1, 1, 1, 1, ],
	[1, 1, 1, 1, 1, 1, 1, 1, 1, 1, 1, 13, 1, 0, 1, 1, 0, 1, ],
	[12, 12, 12, 12, 12, 12, 1, 12, 12, 12, 12, 1, 12, 12, 12, 12, 12, 12, ],
	[12, 12, 12, 12, 12, 12, 1, 1, 1, 1, 1, 1, 12, 12, 12, 12, 12, 12, ],
	[12, 12, 1, 1, 12, 12, 12, 12, 12, 12, 12, 12, 12, 12, 1, 1, 12, 12, ],
	[12, 12, 1, 1, 12, 12, 12, 12, 12, 12, 12, 12, 12, 12, 1, 1, 12, 12, ],
	[12, 12, 1, 1, 12, 12, 12, 12, 12, 12, 12, 12, 12, 12, 1, 1, 12, 12, ],
	[12, 12, 12, 12, 12, 12, 12, 12, 12, 12, 12, 12, 12, 12, 12, 12, 12, 12, ],
]
