connections=[
		],
events={
	
		'exits':[{'name':'LILYCOVE CITY (13.20)','x':13,'y':3},		],
	
		'NPCs':[
			{'is_trainer':0,'b1':7,'b2':0,'sprite':'23','x':4,'y':4},
			{'is_trainer':0,'b1':5,'b2':0,'sprite':'33','x':7,'y':5},
			{'is_trainer':0,'b1':8,'b2':0,'sprite':'84','x':6,'y':1},
			{'is_trainer':0,'b1':8,'b2':0,'sprite':'24','x':15,'y':5},
		],
	
		'signs':[
			{'x':9,'y':1},
			{'x':10,'y':1},
		],
	
		'triggers':[
		],

},
partial_map=[
	[1, 1, 1, 1, 1, 1, 1, 1, 1, 1, 1, 1, 1, 1, 1, 1, 0, 0, ],
	[1, 12, 12, 12, 12, 12, 12, 12, 12, 1, 1, 12, 1, 1, 1, 1, 0, 0, ],
	[1, 12, 12, 12, 12, 12, 12, 12, 12, 12, 12, 12, 1, 1, 1, 1, 1, 1, ],
	[1, 1, 1, 12, 12, 12, 12, 12, 12, 12, 12, 12, 1, 0, 1, 12, 12, 1, ],
	[1, 12, 12, 12, 12, 12, 12, 12, 12, 12, 12, 12, 12, 12, 12, 12, 13, 1, ],
	[1, 1, 1, 12, 12, 13, 13, 12, 12, 13, 13, 12, 12, 12, 12, 12, 13, 1, ],
	[1, 12, 12, 12, 12, 12, 12, 12, 12, 12, 12, 12, 12, 12, 12, 12, 12, 1, ],
	[1, 1, 1, 1, 1, 1, 1, 1, 1, 1, 1, 1, 1, 1, 1, 1, 1, 1, ],
	[1, 1, 1, 1, 1, 1, 1, 1, 1, 1, 1, 1, 1, 1, 1, 1, 1, 1, ],
	[1, 1, 1, 1, 1, 1, 1, 1, 1, 1, 1, 1, 1, 1, 1, 1, 1, 1, ],
	[1, 1, 1, 1, 1, 1, 1, 1, 1, 1, 1, 1, 1, 1, 1, 1, 1, 1, ],
	[1, 1, 1, 1, 1, 1, 1, 1, 1, 1, 1, 1, 1, 1, 1, 1, 1, 1, ],
]
