connections=[
		],
events={
	
		'exits':[{'name':'LILYCOVE CITY (0.5)','x':2,'y':7},{'name':'LILYCOVE CITY (0.5)','x':3,'y':7},		],
	
		'NPCs':[
			{'is_trainer':0,'b1':8,'b2':0,'sprite':'17','x':0,'y':4},
		],
	
		'signs':[
		],
	
		'triggers':[
		],

},
partial_map=[
	[1, 1, 1, 1, 1, 1, 1, 1, ],
	[1, 1, 1, 1, 1, 1, 1, 1, ],
	[12, 12, 12, 12, 12, 12, 12, 12, ],
	[12, 13, 13, 12, 12, 12, 12, 12, ],
	[12, 13, 13, 12, 12, 12, 12, 12, ],
	[12, 12, 12, 12, 12, 12, 12, 12, ],
	[12, 12, 12, 12, 12, 12, 12, 12, ],
	[12, 12, 0, 0, 12, 12, 12, 12, ],
]
