Connections;
Exits;LILYCOVE CITY (0.5);LILYCOVE CITY (0.5);
0 0 0 0 0 0 0 0 0 0 0 0 0 0 0 0 0 0 0 0 0 0 0 0 
0 0 0 0 0 0 0 0 0 0 0 0 0 0 0 0 0 0 0 0 0 0 0 0 
0 0 0 0 0 0 0 0 0 0 0 0 0 0 0 0 0 0 0 0 0 0 0 0 
1 1 1 1 1 1 1 1 1 1 1 1 1 1 1 1 1 1 1 1 1 1 1 1 
12 12 12 1 1 1 1 1 1 1 1 1 1 1 1 1 1 1 1 1 1 1 1 1 
12 12 12 1 5 5 5 5 5 5 5 5 5 5 5 5 5 5 5 5 5 5 5 5 
12 12 12 1 5 5 5 5 5 5 5 5 5 5 5 5 5 5 5 5 5 5 5 5 
12 12 12 1 5 5 5 5 5 5 5 5 5 5 5 5 5 5 5 5 5 5 5 5 
12 12 12 1 5 5 5 5 5 5 5 5 5 5 5 5 5 5 5 5 5 5 5 5 
12 12 12 1 5 5 5 5 5 5 5 5 5 5 5 5 5 5 5 5 5 5 5 5 
12 12 12 1 1 1 1 12 12 1 1 1 1 1 1 1 1 1 13 13 1 1 1 1 
12 12 12 12 12 12 12 12 12 12 12 12 12 12 12 12 12 1 13 13 13 13 13 13 
12 12 12 12 12 12 12 12 12 12 12 12 12 12 12 12 12 1 13 13 13 13 13 13 
12 12 12 12 12 12 12 12 12 12 12 12 12 12 12 12 12 1 13 13 13 13 13 13 
12 12 12 12 12 12 12 12 12 12 12 0 0 12 12 12 12 1 13 13 13 13 13 13 
