connections=[
		],
events={
	
		'exits':[{'name':'LILYCOVE CITY (13.4)','x':19,'y':32},{'name':'LILYCOVE CITY (13.4)','x':30,'y':32},{'name':'LILYCOVE CITY (13.4)','x':20,'y':32},{'name':'LILYCOVE CITY (13.4)','x':31,'y':32},		],
	
		'NPCs':[
			{'is_trainer':0,'b1':2,'b2':0,'sprite':'7','x':30,'y':30},
			{'is_trainer':0,'b1':2,'b2':0,'sprite':'13','x':11,'y':7},
			{'is_trainer':0,'b1':2,'b2':0,'sprite':'14','x':40,'y':8},
			{'is_trainer':0,'b1':8,'b2':0,'sprite':'24','x':12,'y':22},
			{'is_trainer':0,'b1':8,'b2':0,'sprite':'190','x':15,'y':22},
			{'is_trainer':0,'b1':7,'b2':0,'sprite':'44','x':10,'y':25},
			{'is_trainer':0,'b1':7,'b2':0,'sprite':'21','x':12,'y':25},
			{'is_trainer':0,'b1':7,'b2':0,'sprite':'39','x':14,'y':25},
			{'is_trainer':0,'b1':7,'b2':0,'sprite':'28','x':16,'y':25},
			{'is_trainer':0,'b1':10,'b2':0,'sprite':'22','x':8,'y':24},
			{'is_trainer':0,'b1':9,'b2':0,'sprite':'34','x':18,'y':24},
			{'is_trainer':0,'b1':10,'b2':0,'sprite':'7','x':8,'y':22},
			{'is_trainer':0,'b1':8,'b2':0,'sprite':'24','x':24,'y':10},
			{'is_trainer':0,'b1':8,'b2':0,'sprite':'190','x':27,'y':10},
			{'is_trainer':0,'b1':7,'b2':0,'sprite':'26','x':22,'y':13},
			{'is_trainer':0,'b1':7,'b2':0,'sprite':'6','x':24,'y':13},
			{'is_trainer':0,'b1':7,'b2':0,'sprite':'37','x':26,'y':13},
			{'is_trainer':0,'b1':7,'b2':0,'sprite':'18','x':28,'y':13},
			{'is_trainer':0,'b1':10,'b2':0,'sprite':'20','x':20,'y':10},
			{'is_trainer':0,'b1':9,'b2':0,'sprite':'16','x':30,'y':11},
			{'is_trainer':0,'b1':8,'b2':0,'sprite':'19','x':26,'y':8},
			{'is_trainer':0,'b1':8,'b2':0,'sprite':'31','x':13,'y':20},
			{'is_trainer':0,'b1':8,'b2':0,'sprite':'24','x':36,'y':22},
			{'is_trainer':0,'b1':8,'b2':0,'sprite':'190','x':39,'y':22},
			{'is_trainer':0,'b1':7,'b2':0,'sprite':'9','x':34,'y':25},
			{'is_trainer':0,'b1':7,'b2':0,'sprite':'10','x':36,'y':25},
			{'is_trainer':0,'b1':7,'b2':0,'sprite':'13','x':38,'y':25},
			{'is_trainer':0,'b1':7,'b2':0,'sprite':'22','x':40,'y':25},
			{'is_trainer':0,'b1':10,'b2':0,'sprite':'20','x':32,'y':23},
			{'is_trainer':0,'b1':8,'b2':0,'sprite':'19','x':37,'y':20},
			{'is_trainer':0,'b1':9,'b2':0,'sprite':'12','x':42,'y':24},
			{'is_trainer':0,'b1':2,'b2':0,'sprite':'49','x':23,'y':26},
		],
	
		'signs':[
			{'x':27,'y':16},
			{'x':39,'y':28},
			{'x':11,'y':28},
			{'x':15,'y':28},
			{'x':23,'y':16},
			{'x':35,'y':28},
		],
	
		'triggers':[
		],

},
partial_map=[
	[1, 1, 1, 1, 1, 1, 1, 1, 1, 1, 1, 1, 1, 1, 1, 1, 1, 1, 1, 1, 1, 1, 1, 1, 1, 1, 1, 1, 1, 1, 1, 1, 1, 1, 1, 1, 1, 1, 1, 1, 1, 12, 12, 12, 12, 12, 12, 12, 12, 12, 12, ],
	[1, 1, 1, 1, 1, 1, 1, 1, 1, 1, 1, 1, 1, 1, 1, 1, 1, 1, 1, 1, 1, 1, 1, 1, 1, 1, 1, 1, 1, 1, 1, 1, 1, 1, 1, 1, 1, 1, 1, 1, 1, 12, 12, 12, 12, 12, 12, 12, 12, 12, 12, ],
	[1, 1, 1, 1, 1, 1, 1, 1, 1, 1, 1, 1, 1, 1, 1, 1, 1, 1, 1, 1, 1, 1, 1, 1, 1, 1, 1, 1, 1, 1, 1, 1, 1, 1, 1, 1, 1, 1, 1, 1, 1, 1, 1, 1, 1, 1, 12, 12, 12, 12, 12, ],
	[1, 1, 1, 1, 1, 1, 1, 1, 1, 1, 1, 1, 1, 1, 1, 1, 1, 1, 1, 1, 1, 1, 1, 1, 1, 1, 1, 1, 1, 1, 1, 1, 1, 1, 1, 1, 1, 1, 1, 1, 1, 1, 1, 1, 1, 1, 12, 12, 12, 12, 12, ],
	[1, 1, 1, 1, 1, 1, 1, 1, 1, 1, 12, 12, 12, 12, 12, 12, 12, 12, 12, 12, 12, 12, 12, 12, 12, 12, 12, 12, 12, 12, 12, 12, 12, 12, 12, 12, 12, 12, 12, 12, 12, 1, 1, 1, 1, 1, 1, 1, 1, 1, 1, ],
	[1, 1, 1, 1, 1, 1, 1, 1, 1, 1, 12, 12, 12, 12, 12, 12, 12, 12, 12, 12, 12, 12, 12, 12, 12, 12, 12, 12, 12, 12, 12, 12, 12, 12, 12, 12, 12, 12, 12, 12, 12, 1, 1, 1, 1, 1, 1, 1, 1, 1, 1, ],
	[1, 1, 1, 1, 1, 12, 12, 12, 12, 12, 12, 12, 12, 12, 12, 12, 12, 12, 12, 12, 12, 12, 12, 12, 12, 12, 12, 12, 12, 12, 12, 12, 12, 12, 12, 12, 12, 12, 12, 12, 12, 12, 12, 12, 12, 12, 1, 1, 1, 1, 1, ],
	[1, 1, 1, 1, 1, 12, 12, 12, 12, 12, 12, 12, 12, 12, 12, 12, 12, 12, 1, 1, 1, 1, 1, 1, 1, 1, 1, 1, 1, 1, 1, 1, 1, 12, 12, 12, 12, 12, 12, 12, 12, 12, 12, 12, 12, 12, 1, 1, 1, 1, 1, ],
	[12, 12, 12, 12, 12, 12, 12, 12, 12, 12, 12, 12, 12, 12, 12, 12, 12, 12, 1, 12, 12, 12, 12, 12, 12, 12, 12, 12, 12, 12, 12, 12, 1, 12, 12, 12, 12, 12, 12, 12, 12, 12, 12, 12, 12, 12, 12, 12, 12, 12, 12, ],
	[12, 12, 12, 12, 12, 12, 12, 12, 1, 12, 12, 12, 12, 12, 12, 12, 12, 12, 1, 12, 12, 1, 1, 1, 1, 1, 1, 1, 1, 1, 12, 12, 1, 12, 12, 12, 12, 12, 12, 12, 12, 12, 1, 12, 12, 12, 12, 12, 12, 12, 12, ],
	[12, 12, 12, 12, 12, 12, 12, 12, 12, 12, 12, 12, 12, 12, 12, 12, 12, 12, 1, 12, 12, 1, 12, 12, 12, 12, 12, 12, 12, 1, 12, 12, 1, 12, 12, 12, 12, 12, 12, 12, 12, 12, 12, 12, 12, 12, 12, 12, 12, 12, 12, ],
	[12, 12, 1, 12, 12, 1, 12, 12, 12, 12, 12, 12, 12, 12, 12, 12, 12, 12, 1, 12, 12, 1, 12, 12, 12, 12, 0, 16, 0, 1, 12, 12, 1, 12, 12, 12, 12, 12, 12, 12, 12, 12, 12, 12, 12, 1, 12, 12, 1, 12, 12, ],
	[12, 12, 12, 12, 12, 12, 12, 12, 12, 12, 12, 12, 12, 12, 12, 12, 12, 12, 1, 12, 12, 1, 12, 12, 12, 12, 12, 0, 12, 1, 12, 12, 1, 12, 12, 12, 12, 12, 12, 12, 12, 12, 12, 12, 12, 12, 12, 12, 12, 12, 12, ],
	[12, 12, 12, 12, 12, 12, 12, 12, 12, 12, 12, 12, 12, 12, 12, 12, 12, 12, 1, 12, 12, 1, 12, 12, 12, 12, 12, 12, 12, 1, 12, 12, 1, 12, 12, 12, 12, 12, 12, 12, 12, 12, 12, 12, 12, 12, 12, 12, 12, 12, 12, ],
	[12, 12, 12, 12, 12, 12, 12, 12, 12, 12, 12, 12, 12, 12, 12, 12, 12, 12, 1, 12, 12, 1, 1, 1, 12, 12, 12, 1, 1, 1, 12, 12, 1, 12, 12, 12, 12, 12, 12, 12, 12, 12, 12, 12, 12, 12, 12, 12, 12, 12, 12, ],
	[12, 12, 12, 12, 12, 12, 12, 12, 12, 12, 12, 12, 12, 12, 12, 12, 12, 12, 1, 12, 12, 12, 12, 12, 12, 12, 12, 12, 12, 12, 12, 12, 1, 12, 12, 12, 12, 12, 12, 12, 12, 12, 12, 12, 12, 12, 12, 12, 12, 12, 12, ],
	[12, 12, 12, 12, 12, 12, 12, 12, 12, 12, 12, 12, 12, 12, 12, 12, 12, 12, 1, 1, 1, 1, 1, 1, 12, 12, 12, 1, 1, 1, 1, 1, 1, 12, 12, 12, 12, 12, 12, 12, 12, 12, 12, 12, 12, 12, 12, 12, 12, 12, 12, ],
	[12, 12, 12, 12, 12, 12, 12, 12, 12, 12, 12, 12, 12, 12, 12, 12, 12, 12, 12, 12, 12, 12, 12, 12, 12, 12, 12, 12, 12, 12, 12, 12, 12, 12, 12, 12, 12, 12, 12, 12, 12, 12, 12, 12, 12, 12, 12, 12, 12, 12, 12, ],
	[12, 12, 12, 12, 12, 12, 12, 12, 12, 12, 12, 12, 12, 12, 12, 12, 12, 12, 12, 12, 12, 12, 12, 12, 12, 12, 12, 12, 12, 12, 12, 12, 12, 12, 12, 12, 12, 12, 12, 12, 12, 12, 12, 12, 12, 12, 12, 12, 12, 12, 12, ],
	[12, 12, 12, 12, 12, 12, 1, 1, 1, 1, 1, 1, 1, 1, 1, 1, 1, 1, 1, 1, 1, 12, 12, 12, 12, 12, 12, 12, 12, 12, 1, 1, 1, 1, 1, 1, 1, 1, 1, 1, 1, 1, 1, 1, 1, 12, 12, 12, 12, 12, 12, ],
	[12, 12, 12, 12, 12, 12, 1, 12, 12, 12, 12, 12, 12, 12, 12, 12, 12, 12, 12, 12, 1, 12, 12, 12, 12, 12, 12, 12, 12, 12, 1, 12, 12, 12, 12, 12, 12, 12, 12, 12, 12, 12, 12, 12, 1, 12, 12, 12, 12, 12, 12, ],
	[12, 12, 12, 12, 12, 12, 1, 12, 12, 1, 1, 1, 1, 1, 1, 1, 1, 1, 12, 12, 1, 12, 12, 12, 12, 12, 12, 12, 12, 12, 1, 12, 12, 1, 1, 1, 1, 1, 1, 1, 1, 1, 12, 12, 1, 12, 12, 12, 12, 12, 12, ],
	[12, 12, 12, 12, 12, 12, 1, 12, 12, 1, 12, 12, 12, 12, 12, 12, 12, 1, 12, 12, 1, 12, 12, 12, 12, 12, 12, 12, 12, 12, 1, 12, 12, 1, 12, 12, 12, 12, 12, 12, 12, 1, 12, 12, 1, 12, 12, 12, 12, 12, 12, ],
	[12, 12, 12, 12, 12, 12, 1, 12, 12, 1, 12, 12, 12, 12, 0, 16, 0, 1, 12, 12, 1, 12, 12, 12, 12, 12, 12, 12, 12, 12, 1, 12, 12, 1, 12, 12, 12, 12, 0, 16, 0, 1, 12, 12, 1, 12, 12, 12, 12, 12, 12, ],
	[12, 12, 12, 12, 12, 12, 1, 12, 12, 1, 12, 12, 12, 12, 12, 0, 12, 1, 12, 12, 1, 12, 12, 12, 12, 12, 12, 12, 12, 12, 1, 12, 12, 1, 12, 12, 12, 12, 12, 0, 12, 1, 12, 12, 1, 12, 12, 12, 12, 12, 12, ],
	[12, 12, 12, 12, 12, 12, 1, 12, 12, 1, 12, 12, 12, 12, 12, 12, 12, 1, 12, 12, 1, 12, 12, 12, 12, 12, 12, 12, 12, 12, 1, 12, 12, 1, 12, 12, 12, 12, 12, 12, 12, 1, 12, 12, 1, 12, 12, 12, 12, 12, 12, ],
	[12, 12, 12, 12, 12, 12, 1, 12, 12, 1, 1, 1, 12, 12, 12, 1, 1, 1, 12, 12, 1, 12, 12, 12, 12, 12, 12, 12, 12, 12, 1, 12, 12, 1, 1, 1, 12, 12, 12, 1, 1, 1, 12, 12, 1, 12, 12, 12, 12, 12, 12, ],
	[12, 12, 12, 12, 12, 12, 1, 12, 12, 12, 12, 12, 12, 12, 12, 12, 12, 12, 12, 12, 1, 12, 12, 12, 12, 12, 12, 12, 12, 12, 1, 12, 12, 12, 12, 12, 12, 12, 12, 12, 12, 12, 12, 12, 1, 12, 12, 12, 12, 12, 12, ],
	[12, 12, 12, 12, 12, 12, 1, 1, 1, 1, 1, 1, 12, 12, 12, 1, 1, 1, 1, 1, 1, 12, 12, 12, 12, 12, 12, 12, 12, 12, 1, 1, 1, 1, 1, 1, 12, 12, 12, 1, 1, 1, 1, 1, 1, 12, 12, 12, 12, 12, 12, ],
	[12, 12, 12, 12, 12, 12, 12, 12, 12, 12, 12, 12, 12, 12, 12, 12, 12, 12, 12, 12, 12, 12, 12, 12, 12, 12, 12, 12, 12, 12, 12, 12, 12, 12, 12, 12, 12, 12, 12, 12, 12, 12, 12, 12, 12, 12, 12, 12, 12, 12, 12, ],
	[12, 12, 12, 12, 12, 12, 12, 12, 12, 12, 12, 12, 12, 12, 12, 12, 12, 12, 12, 12, 12, 12, 12, 12, 12, 12, 12, 12, 12, 12, 12, 12, 12, 12, 12, 12, 12, 12, 12, 12, 12, 12, 12, 12, 12, 12, 12, 12, 12, 12, 12, ],
	[12, 12, 12, 12, 12, 12, 12, 12, 12, 12, 12, 12, 12, 12, 12, 12, 12, 12, 12, 12, 12, 12, 12, 12, 12, 12, 12, 12, 12, 12, 12, 12, 12, 12, 12, 12, 12, 12, 12, 12, 12, 12, 12, 12, 12, 12, 12, 12, 12, 12, 12, ],
	[12, 12, 12, 1, 12, 12, 12, 1, 12, 12, 12, 1, 12, 12, 12, 12, 12, 12, 12, 0, 0, 12, 12, 12, 12, 12, 12, 12, 12, 12, 0, 0, 12, 12, 12, 12, 12, 12, 12, 1, 12, 12, 12, 1, 12, 12, 12, 1, 12, 12, 12, ],
]
