connections=[
		],
events={
	{
		exits:[LILYCOVE CITY (13.19),LILYCOVE CITY (13.22),LILYCOVE CITY (13.21),		]},
	{
		NPCs:[
			{is_trainer:0,b1:2,b2:0,sprite:12},
			{is_trainer:0,b1:17,b2:0,sprite:18},
			{is_trainer:0,b1:8,b2:0,sprite:24},
			{is_trainer:0,b1:8,b2:0,sprite:24},
			{is_trainer:0,b1:9,b2:0,sprite:24},
			{is_trainer:0,b1:7,b2:0,sprite:24},
			{is_trainer:0,b1:10,b2:0,sprite:20},
		]},
	{
		signs:[
		]},
	{
		triggers:[
		]},

},
[
	[1, 1, 1, 1, 1, 1, 1, 1, 1, 1, 1, 13, 1, 1, 1, 1, 1, 1, ],
	[1, 1, 1, 1, 1, 1, 1, 1, 1, 1, 1, 13, 1, 0, 1, 1, 0, 1, ],
	[12, 12, 12, 12, 12, 1, 12, 12, 12, 12, 12, 1, 12, 12, 12, 12, 12, 12, ],
	[12, 12, 12, 12, 12, 1, 1, 1, 1, 1, 1, 1, 12, 12, 12, 12, 12, 12, ],
	[12, 12, 1, 1, 12, 12, 12, 12, 12, 12, 12, 12, 12, 12, 12, 12, 12, 12, ],
	[12, 12, 1, 1, 12, 12, 13, 13, 12, 12, 13, 13, 12, 12, 13, 13, 13, 13, ],
	[12, 12, 1, 1, 12, 12, 13, 13, 12, 12, 13, 13, 12, 12, 13, 12, 12, 12, ],
	[12, 12, 12, 12, 12, 12, 12, 12, 12, 12, 12, 12, 12, 12, 13, 12, 12, 12, ],
]
