connections=[
		],
events={
	{
		exits:[LILYCOVE CITY (0.5),LILYCOVE CITY (0.5),		]},
	{
		NPCs:[
			{is_trainer:0,b1:7,b2:0,sprite:47},
			{is_trainer:0,b1:9,b2:0,sprite:65},
			{is_trainer:0,b1:7,b2:0,sprite:25},
			{is_trainer:0,b1:8,b2:0,sprite:12},
			{is_trainer:0,b1:7,b2:0,sprite:5},
			{is_trainer:0,b1:8,b2:0,sprite:9},
			{is_trainer:0,b1:10,b2:0,sprite:24},
			{is_trainer:0,b1:9,b2:0,sprite:22},
			{is_trainer:0,b1:8,b2:0,sprite:7},
		]},
	{
		signs:[
		]},
	{
		triggers:[
		]},

},
[
	[1, 1, 1, 1, 1, 1, 1, 1, 1, 1, 1, 1, ],
	[1, 1, 1, 1, 1, 1, 1, 1, 1, 1, 1, 1, ],
	[12, 12, 12, 12, 12, 12, 12, 12, 12, 12, 12, 12, ],
	[12, 12, 12, 12, 1, 1, 1, 1, 12, 12, 12, 12, ],
	[12, 12, 12, 12, 1, 1, 1, 1, 12, 12, 12, 12, ],
	[12, 12, 12, 12, 12, 12, 12, 12, 12, 12, 12, 12, ],
	[12, 12, 12, 12, 12, 12, 12, 12, 12, 12, 12, 12, ],
	[1, 1, 1, 12, 12, 12, 12, 12, 12, 1, 1, 1, ],
	[1, 1, 1, 12, 12, 12, 12, 12, 12, 1, 1, 1, ],
	[12, 12, 12, 12, 1, 1, 1, 1, 12, 12, 12, 12, ],
	[12, 12, 12, 12, 1, 1, 1, 1, 12, 12, 12, 12, ],
	[12, 12, 12, 12, 12, 12, 12, 12, 12, 12, 12, 12, ],
	[12, 12, 12, 12, 12, 12, 12, 12, 12, 12, 12, 12, ],
	[12, 12, 12, 12, 12, 0, 0, 12, 12, 12, 12, 12, ],
]
