Connections;
Exits;LILYCOVE CITY (0.5);LILYCOVE CITY (0.5);
1 1 1 1 1 1 1 1 
1 1 1 1 1 1 1 1 
12 12 12 12 12 12 12 12 
12 13 13 12 12 12 12 12 
12 13 13 12 12 12 12 12 
12 12 12 12 12 12 12 12 
12 12 12 12 12 12 12 12 
12 12 0 0 12 12 12 12 
