connections=[
		],
events={
	
		'exits':[{'name':'LILYCOVE CITY (13.18)','x':16,'y':1},{'name':'LILYCOVE CITY (13.20)','x':13,'y':1},{'name':'LILYCOVE CITY (13.22)','x':2,'y':1},		],
	
		'NPCs':[
			{'is_trainer':0,'b1':2,'b2':0,'sprite':'48','x':0,'y':2},
			{'is_trainer':0,'b1':2,'b2':0,'sprite':'20','x':6,'y':2},
			{'is_trainer':0,'b1':2,'b2':0,'sprite':'35','x':13,'y':4},
			{'is_trainer':0,'b1':7,'b2':0,'sprite':'24','x':7,'y':6},
			{'is_trainer':0,'b1':7,'b2':0,'sprite':'24','x':9,'y':6},
		],
	
		'signs':[
		],
	
		'triggers':[
		],

},
partial_map=[
	[1, 1, 1, 1, 1, 1, 1, 1, 1, 1, 1, 1, 1, 1, 1, 1, 1, 1, ],
	[1, 1, 1, 1, 1, 1, 1, 1, 1, 1, 1, 1, 1, 0, 1, 1, 0, 1, ],
	[12, 12, 12, 12, 12, 12, 12, 12, 12, 12, 12, 12, 12, 12, 12, 12, 12, 12, ],
	[12, 12, 12, 12, 12, 12, 12, 12, 12, 12, 12, 12, 12, 12, 12, 12, 12, 12, ],
	[12, 12, 12, 12, 12, 12, 12, 12, 12, 12, 12, 12, 12, 12, 12, 12, 12, 12, ],
	[12, 13, 13, 12, 12, 12, 1, 1, 1, 1, 1, 12, 12, 13, 13, 13, 13, 12, ],
	[12, 13, 13, 12, 12, 12, 1, 12, 12, 12, 1, 12, 12, 13, 13, 13, 13, 12, ],
	[12, 12, 12, 12, 12, 12, 1, 12, 12, 12, 1, 12, 12, 12, 12, 12, 12, 12, ],
]
