Connections;
Exits;LILYCOVE CITY (13.2);
1 1 1 1 1 1 1 1 1 1 1 1 1 1 1 1 1 1 1 1 1 1 
1 1 1 1 1 1 1 1 1 1 1 1 1 0 1 1 1 1 1 1 1 1 
1 1 1 1 12 12 12 12 12 12 12 1 12 12 12 1 12 12 1 1 1 1 
12 12 12 12 12 12 12 12 12 12 12 12 12 12 12 12 12 12 12 12 12 12 
12 12 12 12 12 12 12 12 12 12 12 12 12 12 12 12 12 12 12 12 12 12 
12 1 1 1 1 12 12 12 12 1 1 1 1 12 12 12 12 1 1 1 1 12 
12 1 1 1 1 12 12 12 12 1 1 1 1 12 12 12 12 1 1 1 1 12 
12 12 12 12 12 12 12 12 12 12 12 12 12 12 12 12 12 12 12 12 12 12 
12 12 12 12 12 12 12 12 12 12 12 12 12 12 12 12 12 12 12 12 12 12 
12 12 12 12 12 1 1 1 1 12 12 12 12 1 1 1 1 12 12 12 12 12 
12 12 12 12 12 1 1 1 1 12 12 12 12 1 1 1 1 12 12 12 12 12 
12 12 12 12 12 12 12 12 12 12 12 12 12 12 12 12 12 12 12 12 12 12 
12 12 12 12 12 12 12 12 12 12 12 12 12 12 12 12 12 12 12 12 12 12 
