connections=[
		],
events={
	{
		exits:[LILYCOVE CITY (13.16),LILYCOVE CITY (13.18),LILYCOVE CITY (13.22),		]},
	{
		NPCs:[
			{is_trainer:0,b1:8,b2:0,sprite:27},
			{is_trainer:0,b1:2,b2:0,sprite:18},
			{is_trainer:0,b1:2,b2:0,sprite:49},
			{is_trainer:0,b1:7,b2:0,sprite:24},
			{is_trainer:0,b1:7,b2:0,sprite:24},
		]},
	{
		signs:[
		]},
	{
		triggers:[
		]},

},
[
	[1, 1, 1, 1, 1, 1, 1, 1, 1, 1, 1, 1, 1, 1, 1, 1, 1, 1, ],
	[1, 1, 1, 1, 1, 1, 1, 1, 1, 1, 1, 1, 1, 0, 1, 1, 0, 1, ],
	[12, 12, 12, 12, 12, 12, 12, 12, 12, 12, 12, 12, 12, 12, 12, 12, 12, 12, ],
	[12, 12, 12, 12, 12, 12, 12, 12, 12, 12, 12, 12, 12, 12, 12, 12, 12, 12, ],
	[12, 12, 1, 1, 12, 12, 12, 12, 12, 12, 12, 12, 12, 12, 1, 1, 12, 1, ],
	[12, 12, 1, 1, 12, 12, 1, 1, 1, 1, 1, 1, 12, 12, 1, 1, 12, 12, ],
	[12, 12, 1, 1, 12, 12, 1, 12, 12, 12, 12, 1, 12, 12, 1, 1, 12, 12, ],
	[12, 12, 12, 12, 12, 12, 1, 12, 12, 12, 12, 1, 12, 12, 12, 12, 12, 1, ],
]
