Connections;up:ROUTE 101 (0.16);
Exits;LITTLEROOT TOWN (1.2);LITTLEROOT TOWN (1.0);LITTLEROOT TOWN (1.4);
1 1 1 1 1 1 1 1 1 13 12 12 1 1 1 1 1 1 1 1 
1 1 1 1 1 1 1 1 1 1 12 12 1 1 1 1 1 1 1 1 
1 1 12 12 12 12 12 12 12 12 12 12 12 12 12 12 12 12 1 1 
1 1 12 12 12 12 12 12 12 12 12 12 12 12 12 12 12 12 1 1 
12 12 12 12 12 12 12 12 12 12 12 12 12 12 12 12 12 12 12 12 
12 12 1 1 1 1 1 12 12 12 12 12 12 1 1 1 1 1 12 12 
12 12 1 1 1 1 1 12 12 12 12 12 12 1 1 1 1 1 12 12 
12 12 1 1 1 1 1 12 12 12 12 12 12 1 1 1 1 1 12 12 
12 12 1 1 1 1 1 13 12 12 12 12 13 1 1 1 1 1 12 12 
12 12 12 12 12 12 12 12 12 12 12 12 12 12 12 12 12 12 12 12 
12 12 60 12 12 12 12 12 12 12 12 60 12 12 12 12 12 12 12 12 
12 12 12 12 12 12 12 12 12 12 12 12 12 12 12 12 12 12 12 12 
12 12 12 12 12 12 12 12 12 12 12 12 12 12 12 12 12 12 12 12 
12 12 12 1 1 1 1 1 1 1 12 12 12 12 12 1 12 12 12 12 
12 12 12 1 1 1 1 1 1 1 12 12 12 12 12 12 12 12 12 12 
12 12 12 1 1 1 1 1 1 1 12 12 12 12 12 12 12 12 12 12 
12 12 12 1 1 1 1 1 1 1 12 12 12 12 12 12 12 12 1 1 
12 12 12 12 12 12 1 12 12 12 12 12 12 12 12 12 12 12 1 1 
1 1 12 12 12 12 12 12 12 12 12 12 12 12 12 12 1 1 1 1 
1 1 12 12 12 12 12 12 12 12 12 12 12 12 12 12 1 1 1 1 
