Connections;
Exits;LITTLEROOT TOWN (0.9);LITTLEROOT TOWN (0.9);
1 1 1 1 1 1 1 1 1 1 1 1 1 
1 1 1 1 1 1 1 1 1 1 1 1 1 
1 12 1 12 12 12 12 12 12 12 12 1 1 
1 12 12 12 12 12 12 12 12 12 12 12 1 
12 12 12 12 12 12 12 12 12 1 1 12 12 
12 12 12 12 12 12 12 12 12 12 12 12 12 
1 1 1 1 12 12 12 12 12 12 1 1 12 
1 1 1 1 12 12 12 12 12 12 1 1 1 
12 12 12 12 12 12 12 12 12 12 12 12 12 
12 1 12 12 12 12 12 12 12 12 12 1 1 
1 1 12 12 12 12 12 12 12 12 12 1 12 
1 1 12 12 12 12 12 12 12 12 12 1 1 
12 12 12 1 12 12 0 0 12 12 12 12 12 
