Connections;
Exits;LITTLEROOT TOWN (1.0);
1 1 1 1 1 1 1 1 1 
1 1 1 1 1 1 1 0 1 
12 12 12 12 12 12 12 12 12 
12 12 12 12 12 12 12 12 12 
0 12 0 12 12 12 12 12 12 
16 1 16 0 12 12 12 12 12 
0 12 0 12 12 12 12 12 12 
12 12 12 12 12 12 12 12 12 
