Connections;
Exits;LITTLEROOT TOWN (0.9);LITTLEROOT TOWN (0.9);LITTLEROOT TOWN (1.1);
1 1 1 1 1 1 1 1 1 1 1 
1 1 1 1 1 1 1 1 1 1 1 
1 1 1 1 1 12 12 1 0 1 1 
12 12 12 12 12 12 12 12 12 12 12 
12 12 1 1 1 12 12 12 12 12 12 
12 12 12 12 12 12 12 12 12 12 12 
12 12 12 13 13 12 12 12 12 12 12 
12 12 12 1 1 12 12 12 12 12 12 
12 12 12 12 12 12 12 12 0 0 12 
