Connections;
Exits;MAGMA HIDEOUT (24.89);
1 1 1 1 1 1 1 1 1 1 1 1 1 1 1 1 1 1 1 1 1 1 1 1 
1 1 1 1 1 1 1 1 1 1 1 1 1 1 1 1 1 1 1 1 1 1 1 1 
1 1 1 1 1 1 1 1 1 1 1 1 1 1 1 1 1 1 1 1 1 1 1 1 
1 1 1 1 1 1 1 1 1 1 1 0 0 0 0 0 0 1 1 13 1 1 1 1 
1 1 1 1 1 1 1 1 1 1 1 0 0 0 0 0 0 1 1 0 1 1 1 1 
1 1 0 1 1 1 1 0 0 0 0 0 0 0 0 0 0 0 0 0 1 1 1 1 
1 1 1 1 1 1 1 0 0 0 1 1 1 1 1 1 1 0 0 0 1 1 1 1 
1 1 1 1 1 1 1 0 0 0 1 1 1 1 1 1 1 0 0 0 1 1 1 1 
1 1 1 1 1 1 1 0 0 0 1 1 1 1 1 1 1 0 0 0 1 1 1 1 
1 1 1 1 1 0 0 0 0 0 0 1 1 1 1 1 1 0 0 0 1 1 1 1 
1 1 1 1 1 1 1 0 0 0 0 1 1 1 1 1 1 0 0 0 13 1 1 1 
1 1 1 0 0 1 1 0 0 0 0 1 1 1 1 1 1 0 0 13 13 13 13 13 
1 1 1 0 0 0 0 0 0 0 0 0 0 0 0 0 0 0 13 1 1 13 13 13 
1 1 1 1 13 0 0 0 0 0 0 0 0 0 0 0 0 13 13 13 1 1 1 13 
1 13 13 13 1 1 13 0 0 0 0 0 0 0 0 0 13 1 1 13 1 1 1 13 
1 13 13 13 1 13 1 13 0 0 0 0 0 0 0 13 13 13 13 13 13 13 13 13 
13 13 13 13 1 1 1 1 1 1 1 1 1 1 1 1 1 13 1 13 1 1 0 13 
