Connections;
Exits;MARINE CAVE (24.103);
1 1 1 1 1 1 1 1 1 1 1 1 1 1 1 1 1 1 1 1 
1 1 1 1 1 1 1 1 1 1 1 1 1 1 12 1 1 1 1 1 
1 1 1 1 1 1 1 1 1 1 1 1 1 12 12 12 1 1 1 1 
1 1 1 1 1 1 1 1 1 1 12 12 12 12 12 12 1 1 1 1 
1 1 1 1 1 1 1 1 1 1 12 12 12 12 12 12 1 1 1 1 
1 1 1 1 1 1 1 1 12 12 12 12 12 12 12 12 1 1 1 1 
1 1 1 1 1 1 1 1 12 12 12 12 12 12 12 12 1 1 1 1 
1 1 1 1 1 1 12 12 12 12 12 4 4 4 4 12 1 1 1 1 
1 1 1 1 1 1 12 12 12 12 4 4 4 4 4 12 1 1 1 1 
1 1 1 1 1 12 12 12 12 4 4 4 4 4 4 12 1 1 1 1 
1 1 1 1 1 12 12 12 4 4 4 4 4 4 4 12 1 1 1 1 
1 1 1 12 12 12 12 4 4 4 4 4 4 4 4 12 12 12 1 1 
1 1 1 12 12 12 4 4 4 4 4 4 4 4 4 12 12 12 1 1 
1 1 1 12 12 4 4 4 4 4 4 4 4 4 4 4 12 12 1 1 
1 1 1 12 12 4 4 4 4 4 4 4 4 4 4 4 12 12 1 1 
1 1 1 12 12 4 4 4 4 4 4 4 4 4 4 4 12 12 1 1 
1 1 1 1 12 4 4 4 4 4 4 4 4 4 4 4 1 1 1 1 
1 1 1 1 1 4 4 4 4 4 4 4 4 4 1 1 1 1 1 1 
1 1 1 1 1 1 1 4 4 4 4 4 4 1 1 1 1 1 1 1 
1 1 1 1 1 1 1 1 1 1 1 1 1 1 1 1 1 1 1 1 
