Connections;
Exits;MAUVILLE CITY (0.2);MAUVILLE CITY (0.2);
1 1 1 1 1 1 1 1 1 1 1 
1 1 1 1 1 1 1 1 1 1 1 
12 12 12 12 12 12 12 12 12 12 12 
12 12 12 12 12 12 12 12 12 12 12 
12 12 12 12 12 1 1 12 12 12 12 
12 12 12 12 12 1 1 12 12 12 12 
12 12 12 12 12 12 12 12 12 12 12 
1 12 12 0 0 12 12 12 12 12 1 
