Connections;up:ROUTE 111 (0.26);down:ROUTE 110 (0.25);left:ROUTE 117 (0.32);right:ROUTE 118 (0.33);
Exits;MAUVILLE CITY (10.0);MAUVILLE CITY (10.5);MAUVILLE CITY (10.1);MAUVILLE CITY (10.7);MAUVILLE CITY (10.2);MAUVILLE CITY (10.3);MAUVILLE CITY (10.4);
1 1 12 12 12 12 12 12 12 12 12 12 1 12 12 12 12 12 12 12 1 1 1 1 1 1 1 1 1 1 1 1 1 1 1 1 1 1 1 1 
1 1 12 12 12 12 12 12 12 12 12 12 1 12 12 12 12 12 12 12 1 12 1 1 1 1 1 1 1 1 1 1 1 1 1 1 1 1 1 1 
1 12 12 12 12 1 1 1 1 1 1 12 1 12 12 12 12 12 12 12 1 1 1 1 1 1 1 1 1 1 1 1 1 1 1 1 1 1 1 1 
1 1 12 12 1 1 1 1 1 1 1 12 1 12 12 12 12 12 12 12 1 1 1 1 1 1 1 1 1 12 1 1 1 1 1 1 1 1 1 1 
1 1 1 1 1 1 1 1 1 1 13 1 1 12 12 12 12 12 12 12 1 1 1 1 1 13 1 1 1 12 1 1 1 1 1 1 1 1 1 1 
1 12 12 12 12 12 12 1 1 1 12 12 12 12 12 12 12 12 12 12 12 1 1 1 1 13 12 12 12 12 12 12 12 1 1 1 1 1 1 1 
13 12 12 12 12 12 12 12 12 12 12 1 12 12 12 12 12 12 12 12 12 12 12 12 12 12 12 12 12 12 12 12 12 1 12 12 12 12 12 1 
12 12 12 12 12 12 12 12 12 12 12 12 12 12 12 12 12 12 12 1 12 12 12 12 12 12 12 12 12 12 12 12 12 12 12 12 12 12 12 12 
12 12 12 12 12 12 12 12 12 12 12 12 12 12 12 12 12 12 12 12 12 12 12 12 12 12 12 12 12 12 12 12 12 12 12 12 12 12 12 12 
12 12 12 12 12 12 12 12 12 12 12 12 12 12 12 12 12 12 12 12 12 12 12 12 12 12 12 12 12 12 12 12 12 12 12 12 12 12 12 12 
12 12 12 12 12 12 12 12 12 12 12 12 12 12 12 12 12 12 12 12 12 12 12 12 12 12 12 12 12 12 12 12 12 12 12 12 12 12 12 12 
13 12 12 12 12 1 1 1 1 1 1 1 12 12 12 12 12 12 12 12 12 12 12 12 12 12 12 12 12 12 12 12 12 12 12 12 12 12 12 12 
1 12 12 12 12 1 1 1 1 1 1 1 12 12 1 1 1 1 1 1 1 1 1 1 1 1 12 12 12 12 12 1 1 1 1 1 1 1 1 1 
1 12 12 12 12 1 1 1 0 1 1 1 12 12 1 12 12 12 1 1 1 1 1 1 1 1 12 12 12 12 12 1 1 1 1 1 1 1 1 1 
1 1 1 1 1 1 1 12 12 12 12 12 12 12 1 12 12 12 1 1 1 1 1 1 1 1 12 12 12 12 12 1 1 1 1 1 1 1 1 1 
1 1 12 12 12 12 1 12 12 12 12 1 12 12 1 12 12 12 12 12 12 12 12 12 12 12 12 12 12 12 12 12 12 12 12 12 1 1 1 1 
1 1 1 1 1 12 1 12 12 12 12 12 12 12 1 12 12 12 12 12 12 12 12 12 12 12 12 12 12 12 12 12 12 12 12 1 1 1 12 12 
1 1 1 1 1 1 1 12 12 12 12 12 12 12 1 12 12 12 12 12 12 12 12 12 12 12 12 12 12 12 12 12 12 12 12 1 1 1 12 12 
1 1 1 1 1 1 1 1 1 1 1 1 1 1 13 12 12 12 12 1 1 1 1 1 1 1 1 1 1 1 1 1 1 12 12 1 4 4 4 4 
1 1 1 1 1 1 1 1 1 12 1 1 12 12 12 12 12 12 12 1 1 1 1 1 1 1 1 12 12 12 12 12 12 12 1 1 4 4 4 4 
