Connections;
Exits;MAUVILLE CITY (0.2);MAUVILLE CITY (0.2);
1 1 1 1 1 1 1 1 1 1 
1 1 1 1 1 1 1 1 1 1 
1 1 1 1 0 0 1 1 1 1 
1 1 1 1 0 0 1 1 1 1 
1 1 1 0 0 0 0 1 1 1 
1 1 1 0 0 0 0 1 1 1 
1 1 1 1 0 0 1 1 1 1 
1 1 1 1 1 1 1 1 1 1 
1 1 1 1 0 0 1 0 0 0 
0 0 0 12 0 0 1 0 12 0 
0 0 0 0 0 0 1 0 0 0 
1 1 1 1 0 0 1 0 0 1 
0 0 0 0 12 0 0 0 0 0 
0 0 0 0 0 0 0 1 1 1 
0 0 0 1 1 1 1 1 1 1 
12 0 0 0 0 0 0 0 0 0 
0 0 0 0 0 0 0 0 0 0 
1 1 0 0 0 0 0 0 1 1 
1 1 0 1 0 0 1 0 1 1 
1 1 0 0 0 0 0 0 1 1 
1 1 0 0 0 0 0 0 1 1 
