Connections;
Exits;MIRAGE TOWER (24.96);MIRAGE TOWER (24.94);
1 1 1 1 1 1 1 1 1 1 1 1 1 1 1 1 1 1 1 1 1 
1 1 1 1 1 1 1 1 1 1 1 1 1 1 1 1 1 1 1 1 1 
1 1 1 1 12 12 12 12 12 12 12 12 12 12 12 12 12 1 1 1 1 
1 1 1 1 12 12 12 12 12 12 12 12 12 12 12 12 12 1 1 1 1 
1 1 12 12 12 12 12 1 1 1 1 1 1 1 12 1 12 12 12 1 1 
1 1 12 12 12 12 1 1 12 12 12 12 12 1 1 12 12 12 12 1 1 
1 1 12 12 12 1 1 12 12 12 12 12 12 12 1 1 12 12 12 1 1 
1 1 12 12 12 1 1 12 12 12 12 12 12 12 1 1 12 12 12 1 1 
1 1 12 12 1 1 1 12 12 12 12 12 12 12 1 1 12 1 1 1 1 
1 1 12 1 12 1 1 12 12 12 12 12 12 12 1 1 1 12 12 1 1 
1 1 12 12 12 1 1 1 12 12 12 12 12 1 1 1 12 12 1 1 1 
1 1 12 12 12 1 1 1 1 1 1 1 1 1 1 1 12 12 1 1 1 
1 1 12 12 12 12 1 1 1 1 1 1 1 1 1 12 12 12 12 1 1 
1 1 1 1 12 12 12 12 12 12 12 12 12 12 12 12 12 1 1 1 1 
1 1 1 1 12 12 12 12 12 12 12 12 12 12 12 12 12 1 1 1 1 
1 12 1 1 1 1 1 1 1 1 1 1 1 1 1 1 1 1 1 12 1 
1 12 1 1 1 1 1 1 1 1 1 1 1 1 1 1 1 1 1 12 1 
