connections=[
		],
events={
	{
		exits:[MIRAGE TOWER (24.96),		]},
	{
		NPCs:[
			{is_trainer:0,b1:8,b2:0,sprite:199},
			{is_trainer:0,b1:8,b2:0,sprite:199},
			{is_trainer:0,b1:1,b2:0,sprite:86},
		]},
	{
		signs:[
		]},
	{
		triggers:[
		]},

},
[
	[1, 1, 1, 1, 1, 1, 1, 1, 1, 1, 1, 1, 1, ],
	[1, 1, 1, 12, 12, 12, 12, 12, 12, 12, 1, 1, 1, ],
	[1, 12, 1, 1, 16, 16, 16, 16, 16, 1, 12, 12, 1, ],
	[1, 12, 12, 1, 16, 16, 16, 16, 16, 1, 12, 12, 1, ],
	[1, 12, 12, 1, 16, 16, 16, 16, 16, 1, 12, 12, 1, ],
	[1, 12, 12, 1, 16, 16, 16, 16, 16, 1, 12, 12, 1, ],
	[1, 12, 12, 1, 1, 1, 0, 1, 1, 1, 12, 12, 1, ],
	[1, 1, 12, 12, 12, 12, 12, 12, 12, 12, 12, 12, 1, ],
	[1, 1, 1, 12, 12, 12, 12, 12, 12, 12, 1, 1, 1, ],
	[1, 0, 1, 1, 1, 1, 1, 1, 1, 1, 1, 0, 1, ],
]
