connections=[
		],
events={
	
		'exits':[{'name':'MOSSDEEP CITY (0.6)','x':5,'y':9},{'name':'MOSSDEEP CITY (0.6)','x':6,'y':9},{'name':'MOSSDEEP CITY (14.12)','x':2,'y':0},		],
	
		'NPCs':[
			{'is_trainer':0,'b1':8,'b2':0,'sprite':'21','x':6,'y':2},
			{'is_trainer':0,'b1':8,'b2':0,'sprite':'65','x':4,'y':2},
		],
	
		'signs':[
			{'x':3,'y':0},
			{'x':0,'y':1},
			{'x':1,'y':1},
		],
	
		'triggers':[
		],

},
partial_map=[
	[1, 1, 1, 1, 1, 12, 1, 1, 1, 1, 12, 1, ],
	[1, 1, 1, 1, 1, 12, 1, 1, 1, 1, 1, 1, ],
	[12, 12, 1, 1, 1, 12, 1, 1, 1, 12, 12, 12, ],
	[12, 12, 1, 1, 1, 1, 1, 1, 1, 12, 12, 12, ],
	[12, 12, 12, 12, 12, 12, 12, 12, 12, 12, 12, 12, ],
	[12, 12, 12, 12, 12, 12, 12, 12, 12, 12, 12, 12, ],
	[12, 12, 1, 1, 12, 12, 12, 1, 1, 12, 12, 12, ],
	[12, 12, 1, 1, 12, 12, 12, 1, 1, 12, 12, 12, ],
	[12, 12, 12, 12, 12, 12, 12, 12, 12, 12, 12, 12, ],
	[12, 12, 12, 12, 12, 12, 12, 12, 12, 12, 12, 12, ],
]
