Connections;up:ROUTE 125 (0.40);down:ROUTE 127 (0.42);left:ROUTE 124 (0.39);
Exits;MOSSDEEP CITY (14.1);MOSSDEEP CITY (14.0);MOSSDEEP CITY (14.3);MOSSDEEP CITY (14.2);MOSSDEEP CITY (14.5);MOSSDEEP CITY (14.6);MOSSDEEP CITY (14.7);MOSSDEEP CITY (14.8);MOSSDEEP CITY (14.9);MOSSDEEP CITY (14.11);
4 4 4 4 1 12 12 1 1 1 13 12 12 12 5 1 1 5 5 5 4 4 4 4 4 4 4 4 4 4 4 4 4 4 4 4 4 4 4 4 4 4 4 4 4 4 4 4 4 4 4 4 4 5 5 4 4 4 4 4 4 4 4 4 4 4 4 4 4 4 4 4 4 4 4 4 4 4 4 4 
4 4 4 4 5 5 13 12 12 12 12 12 5 5 5 4 4 4 4 4 4 4 4 4 4 4 4 4 4 4 4 4 4 4 4 4 4 4 4 4 4 4 4 4 4 4 4 4 4 4 4 5 5 5 5 4 4 4 4 4 4 4 4 4 4 4 4 4 4 4 4 4 4 4 4 4 4 4 4 4 
4 4 4 4 5 5 5 5 5 5 5 5 5 4 4 4 4 4 4 4 4 4 4 4 4 4 4 4 4 4 4 4 4 4 4 4 4 4 4 4 4 4 4 4 4 4 4 4 4 4 4 5 5 4 4 4 4 4 4 4 4 4 4 4 4 4 4 4 4 4 4 4 4 4 4 4 4 4 4 4 
4 4 1 1 5 5 4 4 4 4 4 4 4 4 4 4 4 4 4 4 12 12 12 4 4 4 4 4 4 4 4 4 4 4 4 4 4 4 4 4 4 4 4 4 4 4 4 1 1 1 1 1 1 5 4 4 5 5 5 1 1 4 4 4 4 4 4 4 4 4 4 4 4 4 4 4 4 4 4 4 
5 5 1 1 4 4 4 4 4 4 4 4 4 12 12 12 12 12 12 12 12 12 12 12 12 12 4 4 4 4 1 16 16 16 16 16 16 16 16 16 16 16 1 4 4 4 1 1 1 1 1 1 28 28 28 28 28 1 28 1 4 4 4 4 4 4 4 4 4 4 4 4 4 4 4 4 4 4 4 4 
5 5 4 4 4 4 4 4 4 4 4 4 12 12 12 12 12 12 12 12 12 1 12 12 12 1 16 16 16 16 16 20 20 20 20 16 16 16 16 16 16 16 16 16 16 16 1 1 1 1 1 1 28 28 28 28 1 1 1 37 1 4 4 4 4 4 4 4 4 4 4 4 4 4 4 4 4 4 4 4 
4 4 4 4 4 4 4 4 4 4 4 12 12 12 12 1 12 12 12 12 12 12 12 1 16 16 16 20 20 20 20 1 1 1 1 1 1 1 1 1 1 16 16 20 20 20 1 1 1 1 1 1 28 28 28 28 28 28 1 36 36 36 36 36 36 36 36 36 36 36 1 4 4 4 4 4 4 4 4 4 
4 4 4 4 4 4 4 4 4 4 12 12 12 1 1 20 20 20 20 20 20 20 20 20 1 1 20 21 21 21 21 20 1 1 20 1 1 1 1 1 1 16 20 1 1 1 28 28 28 28 28 28 28 28 28 28 1 36 1 36 36 36 36 36 36 36 36 36 36 36 1 1 4 4 4 4 4 4 4 4 
4 4 4 4 4 4 4 4 4 4 12 12 12 1 1 1 1 20 21 21 21 21 20 1 1 1 1 1 1 1 1 20 20 20 20 1 1 1 1 1 1 20 1 1 1 1 28 28 28 28 28 28 28 28 1 36 1 1 36 36 1 1 1 1 1 1 1 1 1 36 1 1 36 1 4 4 4 4 4 4 
4 4 4 4 4 4 4 4 4 4 12 12 12 1 1 20 20 20 1 1 1 1 1 1 1 1 20 1 1 1 21 20 20 20 1 20 20 1 1 1 20 1 1 1 28 28 28 28 28 28 28 28 28 1 36 1 36 1 36 36 1 1 1 1 1 1 1 1 1 36 1 36 37 1 1 4 4 4 4 4 
4 4 4 4 4 4 4 4 4 4 12 12 1 1 1 20 20 20 1 1 1 1 20 20 20 20 20 20 20 20 20 20 20 20 20 20 20 20 20 20 20 20 1 1 28 28 28 28 28 28 28 28 1 1 36 1 36 1 36 36 1 1 1 1 1 1 1 1 1 36 36 37 1 1 1 1 4 4 4 4 
4 4 4 4 4 4 4 4 4 4 12 12 12 1 1 1 20 20 20 20 20 20 20 20 20 20 20 20 20 20 20 20 20 20 20 20 20 20 20 20 20 20 1 1 28 28 28 28 28 28 28 1 36 1 1 36 36 1 36 36 1 1 1 1 1 1 1 1 1 36 36 1 1 1 1 1 1 4 4 4 
4 4 4 4 4 4 4 4 4 4 12 12 12 1 1 1 20 20 20 20 20 20 20 20 20 20 20 20 20 20 20 20 20 20 20 20 20 20 20 20 20 1 28 28 28 28 28 28 28 28 28 1 36 1 1 36 36 1 36 36 1 1 1 1 1 1 1 1 1 36 36 1 1 1 1 1 1 1 4 4 
4 4 4 4 4 4 4 4 4 4 12 12 12 12 1 1 1 20 20 20 20 20 20 20 1 1 20 20 20 20 20 20 20 20 20 20 20 20 20 20 1 1 28 1 28 28 28 28 28 28 28 1 36 1 1 1 36 1 36 36 1 1 1 1 1 1 1 1 1 36 36 1 1 1 1 1 1 1 36 1 
4 4 4 4 4 4 4 4 4 4 12 12 12 12 1 1 1 1 1 1 1 20 20 20 20 1 1 1 1 1 1 20 20 20 20 20 20 20 20 20 1 1 1 1 1 28 28 28 28 28 28 1 36 1 36 1 1 1 36 36 1 1 1 1 1 1 1 1 1 36 36 1 1 1 1 1 1 28 1 1 
4 4 4 4 4 4 4 4 4 4 12 12 12 12 12 1 1 1 1 1 1 20 1 1 1 1 20 1 1 1 1 20 20 20 20 20 20 20 20 20 1 1 28 28 28 28 28 28 28 28 28 1 1 1 36 36 1 1 1 36 1 1 1 1 1 1 1 1 1 36 36 1 1 1 1 1 1 28 1 1 
4 4 4 4 4 4 4 4 4 4 4 12 12 12 12 1 1 1 1 1 1 20 20 20 20 1 20 1 1 1 1 20 20 20 20 20 1 1 1 1 1 1 1 28 28 28 28 28 28 28 28 28 1 1 1 36 1 36 1 1 36 36 36 36 36 36 1 36 36 36 1 1 1 1 1 1 1 28 1 1 
4 4 4 4 4 4 4 4 4 4 4 12 12 12 12 1 1 20 20 20 20 20 20 20 20 20 20 20 20 20 20 20 20 20 20 20 1 1 1 1 1 1 1 1 28 28 28 28 28 28 28 28 1 1 1 1 1 1 1 1 1 1 36 36 36 36 36 36 36 36 1 1 1 1 1 1 28 1 1 1 
4 4 4 4 4 4 4 4 4 4 4 12 12 12 12 1 1 1 20 20 20 20 20 20 20 20 20 20 20 20 20 20 20 20 20 20 1 1 1 1 20 1 1 1 28 28 28 28 28 28 28 28 28 1 1 1 1 1 1 1 1 1 1 36 36 36 1 1 1 1 1 1 36 1 1 1 28 1 1 1 
12 12 12 12 4 4 4 4 4 4 4 12 12 12 12 1 1 1 20 1 1 20 20 20 20 20 20 20 20 20 20 20 20 20 20 20 20 20 20 20 20 20 1 1 1 28 28 28 28 28 28 28 28 28 1 1 1 1 1 1 1 1 1 36 36 36 1 1 1 1 1 1 1 1 1 1 28 1 1 1 
12 12 12 12 12 12 12 4 4 4 4 4 12 12 12 12 1 1 1 1 1 1 1 20 20 20 20 20 20 20 20 20 20 20 20 20 20 20 20 20 20 20 1 1 1 1 28 28 28 1 28 28 28 28 28 28 1 1 1 1 1 1 36 36 36 36 36 36 36 36 1 1 1 1 1 1 28 1 1 1 
12 12 12 12 12 12 12 12 12 4 4 4 12 12 12 12 1 1 1 1 1 20 20 20 20 20 20 20 20 20 20 20 20 20 20 21 21 21 21 21 20 20 20 1 1 1 1 1 1 1 1 28 28 28 28 28 28 29 1 1 1 1 1 36 36 36 1 1 1 1 1 1 1 1 28 1 1 1 1 1 
12 12 12 12 12 12 12 12 12 12 12 12 12 12 12 12 12 12 12 1 1 1 1 1 20 20 20 20 20 1 1 20 20 20 20 21 21 21 21 21 20 20 20 20 1 1 1 1 1 1 1 28 28 28 28 28 28 28 28 28 1 1 1 0 0 0 1 1 1 1 1 1 28 28 28 1 1 1 1 1 
12 12 12 13 1 12 12 12 12 12 12 12 12 12 12 12 12 12 12 1 1 1 1 1 20 20 20 20 1 1 20 20 20 20 20 1 21 1 1 1 20 20 20 20 20 20 1 1 1 1 1 1 28 28 28 28 28 28 28 28 28 28 28 28 28 28 1 1 1 1 28 28 28 1 1 1 1 1 1 1 
12 12 12 12 13 13 12 12 12 12 12 12 12 12 12 12 12 12 12 12 12 12 1 1 1 20 20 1 1 1 1 20 20 20 20 1 21 1 1 1 20 20 20 20 20 20 20 20 20 1 1 1 28 28 28 28 28 28 28 28 28 28 28 28 28 28 1 1 1 1 28 28 1 1 1 1 1 1 1 4 
12 12 12 12 12 12 12 12 12 12 12 12 12 12 12 12 12 12 12 12 12 12 1 1 1 0 0 1 1 1 1 20 20 20 20 20 20 20 20 20 20 20 20 20 20 20 20 20 20 20 1 1 1 1 1 28 28 28 28 28 28 28 28 28 28 28 1 1 1 1 28 28 1 1 1 1 1 1 1 4 
12 12 12 12 12 12 12 12 12 12 12 12 12 12 12 12 12 12 12 12 12 12 12 12 12 12 12 12 12 1 1 20 20 20 20 20 20 20 20 20 20 20 20 20 20 20 20 20 20 20 1 1 1 1 1 1 28 28 28 28 28 28 28 28 28 28 28 28 28 28 28 1 1 1 1 1 1 1 1 4 
4 12 12 12 13 13 12 12 12 12 12 12 12 12 12 12 12 12 12 12 12 12 12 12 12 12 12 12 12 1 1 1 0 0 1 1 1 1 1 1 1 1 1 1 20 20 20 20 20 20 20 20 20 1 1 1 1 0 0 1 1 1 1 1 1 28 28 28 28 1 28 1 1 1 1 1 1 4 4 4 
4 12 12 12 12 12 12 12 12 12 4 4 4 4 12 12 12 12 12 12 12 12 12 12 12 12 12 12 12 1 1 1 0 0 1 1 1 1 1 1 20 1 1 1 20 20 20 20 20 20 20 20 20 20 1 1 1 20 20 1 1 1 1 28 1 1 28 28 1 1 1 1 1 1 1 1 4 4 4 4 
4 12 12 12 12 12 12 12 12 12 4 4 4 4 4 4 4 12 12 12 12 12 12 12 12 12 12 12 12 12 12 12 12 12 12 1 1 1 1 1 1 1 1 1 20 20 20 20 20 20 20 20 20 20 20 20 20 20 20 20 20 20 1 1 1 1 1 1 1 1 1 1 1 1 1 1 4 4 4 4 
4 4 12 12 12 12 12 12 12 4 4 4 4 4 4 4 4 4 4 4 4 4 4 12 12 12 12 12 12 12 12 12 12 12 12 12 1 1 1 1 1 1 1 1 1 20 20 20 20 20 20 20 20 20 20 20 20 20 20 20 20 20 20 20 1 1 1 1 1 1 1 1 1 1 1 4 4 4 4 4 
4 4 4 12 12 12 12 12 4 4 4 4 4 4 4 4 4 4 4 4 4 4 4 4 4 4 4 4 12 12 12 12 12 12 12 1 1 1 1 1 1 12 1 20 1 1 20 20 1 1 1 20 20 20 20 20 20 20 20 20 20 20 20 20 20 20 20 1 1 1 1 1 1 1 1 4 4 4 4 4 
4 4 4 4 4 4 4 4 4 4 4 4 4 4 4 4 4 4 4 4 4 4 4 4 4 4 4 4 4 4 4 4 12 12 1 1 0 0 1 1 1 1 1 20 20 20 20 20 20 20 1 1 1 1 20 20 20 20 20 20 20 20 20 20 20 1 1 1 20 20 1 1 1 1 1 4 4 4 4 4 
4 4 4 4 4 4 4 4 4 4 4 4 4 4 4 4 4 4 4 4 4 4 4 4 4 4 4 4 4 4 4 4 4 4 12 1 1 1 1 1 1 12 1 20 1 1 20 20 20 20 20 20 20 1 1 1 1 1 1 1 20 20 20 1 1 1 20 20 20 20 1 4 4 4 4 4 4 4 4 4 
1 1 1 1 1 1 1 1 5 4 5 5 4 4 4 4 4 4 4 4 4 4 4 4 4 4 4 4 4 4 4 4 4 4 4 12 1 1 12 12 12 12 1 1 1 20 20 20 20 20 20 20 20 20 20 20 20 20 20 1 1 1 1 1 1 1 1 1 1 1 1 4 4 4 4 4 4 4 4 4 
13 5 13 5 13 5 13 5 5 5 5 5 4 4 4 4 4 4 4 4 4 4 4 4 4 4 4 4 4 4 4 4 4 4 4 1 1 1 1 1 1 12 1 1 1 1 1 1 1 20 20 20 20 20 20 20 20 20 20 20 20 20 20 20 1 4 4 4 4 4 4 4 4 4 4 1 5 4 4 4 
5 5 5 5 5 13 5 13 5 1 1 1 1 1 1 1 1 1 1 1 1 5 4 4 4 4 4 4 4 4 4 4 4 4 4 12 12 12 1 1 1 1 12 12 12 1 1 12 1 1 1 1 1 1 1 1 1 1 1 1 1 1 1 1 1 4 4 4 4 4 4 4 4 4 1 4 5 4 4 4 
13 13 13 5 5 5 5 5 5 5 5 5 13 13 13 12 12 12 12 13 4 1 5 4 4 4 4 4 4 4 4 4 4 4 4 1 1 1 1 1 1 12 12 12 1 1 1 1 12 12 12 12 12 12 4 4 4 4 4 4 4 4 4 4 4 4 4 4 4 4 4 4 4 4 5 4 5 4 4 4 
13 13 13 13 5 5 5 5 5 5 5 13 13 5 13 13 12 13 4 12 13 4 5 4 4 4 4 4 4 4 4 4 4 4 4 12 1 1 12 12 1 1 12 12 12 1 1 12 4 4 4 4 4 4 4 4 4 4 4 4 4 4 4 4 4 4 4 4 4 4 4 4 4 1 12 12 0 5 4 4 
13 13 13 13 5 5 5 5 5 5 5 13 13 13 13 13 12 12 13 12 13 4 5 5 5 4 4 4 4 4 4 4 4 4 4 1 1 12 12 1 1 1 1 12 1 1 4 4 4 4 4 4 4 4 4 4 4 4 4 4 4 4 4 4 4 4 4 4 4 4 4 4 4 1 12 1 13 5 4 4 
