Connections;
Exits;MOSSDEEP CITY (0.6);MOSSDEEP CITY (0.6);MOSSDEEP CITY (14.12);
1 1 1 1 1 12 1 1 1 1 12 1 
1 1 1 1 1 12 1 1 1 1 1 1 
12 12 1 1 1 12 1 1 1 12 12 12 
12 12 1 1 1 1 1 1 1 12 12 12 
12 12 12 12 12 12 12 12 12 12 12 12 
12 12 12 12 12 12 12 12 12 12 12 12 
12 12 1 1 12 12 12 1 1 12 12 12 
12 12 1 1 12 12 12 1 1 12 12 12 
12 12 12 12 12 12 12 12 12 12 12 12 
12 12 12 12 12 12 12 12 12 12 12 12 
