Connections;
Exits;MOSSDEEP CITY (0.6);MOSSDEEP CITY (0.6);MOSSDEEP CITY (14.10);
1 0 0 1 1 1 1 1 1 1 1 1 1 1 1 0 
1 1 1 1 1 1 1 1 1 1 1 1 1 0 1 1 
12 12 12 12 12 12 12 12 12 12 12 12 12 12 12 12 
12 12 12 12 12 12 12 12 12 12 12 12 12 12 12 12 
12 12 12 12 12 12 12 12 12 12 12 12 12 12 12 12 
12 12 1 1 1 1 12 12 12 12 1 1 12 1 1 12 
12 12 1 1 1 1 12 12 12 12 12 12 12 12 12 12 
12 12 12 12 12 12 12 12 12 12 1 1 1 1 12 12 
12 12 12 12 12 12 12 12 12 12 1 1 1 1 12 12 
12 12 12 12 12 12 12 0 0 12 12 12 12 12 12 12 
