connections=[
		],
events={
	{
		exits:[MOSSDEEP CITY (0.6),MOSSDEEP CITY (0.6),MOSSDEEP CITY (14.12),		]},
	{
		NPCs:[
			{is_trainer:0,b1:8,b2:0,sprite:21},
			{is_trainer:0,b1:8,b2:0,sprite:65},
		]},
	{
		signs:[
			{x:3,y:0},
			{x:0,y:1},
			{x:1,y:1},
		]},
	{
		triggers:[
		]},

},
[
	[1, 1, 1, 1, 1, 12, 1, 1, 1, 1, 12, 1, ],
	[1, 1, 1, 1, 1, 12, 1, 1, 1, 1, 1, 1, ],
	[12, 12, 1, 1, 1, 12, 1, 1, 1, 12, 12, 12, ],
	[12, 12, 1, 1, 1, 1, 1, 1, 1, 12, 12, 12, ],
	[12, 12, 12, 12, 12, 12, 12, 12, 12, 12, 12, 12, ],
	[12, 12, 12, 12, 12, 12, 12, 12, 12, 12, 12, 12, ],
	[12, 12, 1, 1, 12, 12, 12, 1, 1, 12, 12, 12, ],
	[12, 12, 1, 1, 12, 12, 12, 1, 1, 12, 12, 12, ],
	[12, 12, 12, 12, 12, 12, 12, 12, 12, 12, 12, 12, ],
	[12, 12, 12, 12, 12, 12, 12, 12, 12, 12, 12, 12, ],
]
