Connections;
Exits;MOSSDEEP CITY (0.6);MOSSDEEP CITY (0.6);
1 1 1 1 1 1 1 1 1 1 1 
1 1 1 1 1 1 1 1 1 1 1 
12 12 12 12 12 12 12 12 12 12 12 
12 12 12 12 13 13 13 13 12 12 12 
12 12 12 12 13 13 13 13 12 12 13 
12 12 12 12 12 12 12 12 12 12 12 
12 12 12 12 12 12 12 12 12 12 13 
12 12 12 0 0 12 12 12 12 12 12 
