connections=[
		],
events={
	{
		exits:[MOSSDEEP CITY (14.9),		]},
	{
		NPCs:[
			{is_trainer:0,b1:7,b2:0,sprite:15},
			{is_trainer:0,b1:7,b2:0,sprite:48},
			{is_trainer:0,b1:2,b2:0,sprite:46},
			{is_trainer:0,b1:8,b2:0,sprite:134},
			{is_trainer:0,b1:10,b2:0,sprite:119},
			{is_trainer:0,b1:7,b2:0,sprite:119},
			{is_trainer:0,b1:9,b2:0,sprite:119},
			{is_trainer:0,b1:10,b2:0,sprite:119},
			{is_trainer:0,b1:7,b2:0,sprite:196},
		]},
	{
		signs:[
		]},
	{
		triggers:[
		]},

},
[
	[1, 0, 0, 1, 1, 1, 1, 1, 1, 1, 1, 1, 1, 1, 1, 0, ],
	[1, 1, 1, 1, 1, 1, 1, 1, 1, 1, 1, 1, 1, 0, 1, 1, ],
	[1, 12, 12, 12, 12, 12, 12, 12, 12, 12, 12, 12, 12, 12, 12, 12, ],
	[1, 12, 12, 12, 12, 12, 12, 12, 12, 12, 12, 12, 12, 12, 12, 12, ],
	[1, 1, 1, 1, 1, 1, 1, 1, 1, 1, 1, 1, 1, 12, 12, 12, ],
	[12, 12, 12, 12, 12, 12, 12, 12, 12, 12, 12, 12, 12, 12, 12, 12, ],
	[12, 12, 12, 12, 12, 12, 12, 12, 12, 12, 12, 12, 12, 12, 12, 12, ],
	[12, 12, 1, 1, 12, 1, 1, 12, 1, 1, 12, 1, 1, 12, 12, 12, ],
	[12, 12, 12, 12, 12, 12, 12, 12, 12, 12, 12, 12, 12, 12, 12, 12, ],
	[12, 12, 12, 12, 12, 12, 12, 12, 12, 12, 12, 12, 12, 12, 12, 12, ],
]
