Connections;
Exits;MOSSDEEP CITY (14.11);
1 1 1 1 1 1 1 1 1 1 1 1 
0 1 1 0 1 1 1 1 1 1 1 0 
13 12 12 12 12 12 12 12 12 12 12 13 
12 12 12 12 12 12 12 12 12 12 12 12 
12 12 12 12 12 12 12 12 12 12 12 12 
12 12 12 12 12 12 12 12 12 12 12 12 
12 12 12 12 12 12 12 12 12 12 12 12 
12 12 12 12 12 12 12 12 12 12 12 12 
1 12 12 12 12 12 12 12 12 12 12 1 
