Connections;
Exits;MT. PYRE (24.20);MT. PYRE (24.18);MT. PYRE (24.20);MT. PYRE (24.18);MT. PYRE (24.18);
1 1 1 1 1 1 1 1 1 1 1 1 1 
1 1 12 1 1 1 1 1 1 1 1 1 1 
1 12 12 12 1 12 1 1 1 1 1 1 1 
1 12 12 12 1 12 1 1 1 1 1 1 1 
1 1 12 1 1 1 1 1 1 1 1 1 1 
1 1 12 1 1 1 1 1 1 1 12 1 1 
1 12 12 12 1 1 1 1 1 12 12 12 1 
1 12 12 12 1 12 12 12 1 12 12 12 1 
12 12 12 12 12 12 12 12 12 12 12 12 12 
1 1 12 12 12 1 1 1 12 12 12 1 1 
12 12 1 1 1 12 13 12 1 1 1 12 12 
1 12 12 1 12 12 12 12 12 1 12 12 1 
1 12 12 12 12 12 12 12 12 12 12 12 12 
