Connections;
Exits;MT. CHIMNEY (24.12);MT. CHIMNEY (24.12);
0 1 0 1 1 0 1 0 1 1 0 1 0 
1 1 1 1 1 1 1 1 1 1 1 1 1 
12 12 12 12 12 12 12 12 12 12 12 12 12 
1 1 1 1 1 1 1 1 1 1 1 1 1 
1 1 1 1 1 1 12 1 1 1 1 1 1 
1 1 1 1 1 1 12 1 1 1 1 1 1 
1 1 1 1 1 1 12 1 1 1 1 1 1 
12 12 12 12 12 12 12 0 12 12 12 12 1 
12 12 12 12 12 12 12 12 12 12 12 12 1 
12 12 12 12 12 12 12 12 12 12 12 12 1 
12 12 0 0 12 12 12 12 12 0 0 12 12 
12 12 12 12 12 12 0 0 12 12 12 12 12 
