connections=[
		],
events={
	{
		exits:[MT. PYRE (24.16),MT. PYRE (24.18),MT. PYRE (24.18),MT. PYRE (24.18),MT. PYRE (24.16),MT. PYRE (24.16),		]},
	{
		NPCs:[
			{is_trainer:1,b1:18,b2:0,sprite:37},
			{is_trainer:1,b1:17,b2:0,sprite:47},
			{is_trainer:0,b1:1,b2:0,sprite:59},
			{is_trainer:1,b1:14,b2:0,sprite:20},
		]},
	{
		signs:[
		]},
	{
		triggers:[
		]},

},
[
	[1, 1, 1, 1, 1, 1, 1, 1, 1, 1, 1, 1, 1, ],
	[1, 1, 12, 1, 1, 1, 1, 1, 1, 1, 12, 1, 1, ],
	[1, 12, 12, 12, 12, 1, 1, 1, 12, 12, 12, 12, 1, ],
	[1, 12, 12, 12, 1, 1, 1, 1, 1, 12, 12, 12, 1, ],
	[12, 12, 12, 12, 12, 12, 12, 12, 12, 12, 12, 12, 12, ],
	[1, 12, 12, 12, 12, 12, 1, 12, 12, 12, 12, 12, 1, ],
	[1, 12, 12, 1, 1, 1, 1, 1, 1, 1, 12, 12, 1, ],
	[12, 12, 12, 12, 12, 12, 12, 12, 12, 12, 12, 12, 12, ],
	[1, 1, 1, 1, 1, 1, 1, 1, 1, 1, 12, 12, 12, ],
	[1, 1, 1, 1, 1, 1, 1, 1, 1, 1, 12, 12, 12, ],
	[12, 12, 12, 12, 12, 12, 12, 1, 1, 12, 12, 12, 12, ],
	[12, 12, 12, 1, 1, 12, 12, 1, 1, 12, 12, 1, 1, ],
	[12, 12, 12, 1, 1, 12, 12, 1, 1, 12, 12, 1, 1, ],
]
