Connections;
Exits;MT. PYRE (24.15);MT. PYRE (24.17);MT. PYRE (24.17);MT. PYRE (24.17);MT. PYRE (24.15);
1 1 1 1 1 1 1 1 1 1 1 1 1 
1 1 12 1 1 1 1 1 1 1 12 1 1 
12 12 12 12 12 12 1 1 12 12 12 12 1 
12 12 12 12 12 12 12 1 12 12 12 12 1 
1 1 12 12 12 12 1 12 1 1 12 12 12 
1 1 12 12 12 12 1 12 1 12 12 12 12 
12 12 1 12 12 12 12 12 12 12 1 1 12 
12 12 1 12 12 12 12 12 12 12 1 1 12 
1 1 1 1 1 1 12 12 1 1 12 12 1 
1 12 12 12 1 1 12 12 1 1 12 12 1 
12 12 12 12 12 12 12 12 12 12 12 12 12 
1 1 12 12 1 1 12 12 1 1 12 1 1 
1 1 12 12 1 1 12 12 1 1 12 1 1 
