connections=[
		],
events={
	{
		exits:[MT. PYRE (24.15),MT. PYRE (24.17),MT. PYRE (24.17),MT. PYRE (24.17),MT. PYRE (24.15),		]},
	{
		NPCs:[
			{is_trainer:1,b1:10,b2:0,sprite:39},
			{is_trainer:0,b1:1,b2:0,sprite:59},
			{is_trainer:0,b1:10,b2:0,sprite:16},
			{is_trainer:0,b1:8,b2:0,sprite:25},
			{is_trainer:1,b1:8,b2:0,sprite:26},
			{is_trainer:1,b1:8,b2:0,sprite:65},
			{is_trainer:1,b1:7,b2:0,sprite:44},
			{is_trainer:1,b1:17,b2:0,sprite:40},
		]},
	{
		signs:[
		]},
	{
		triggers:[
		]},

},
[
	[1, 1, 1, 1, 1, 1, 1, 1, 1, 1, 1, 1, 1, ],
	[1, 1, 12, 1, 1, 1, 1, 1, 1, 1, 12, 1, 1, ],
	[12, 12, 12, 12, 12, 12, 1, 1, 12, 12, 12, 12, 1, ],
	[12, 12, 12, 12, 12, 12, 12, 1, 12, 12, 12, 12, 1, ],
	[1, 1, 12, 12, 12, 12, 1, 12, 1, 1, 12, 12, 12, ],
	[1, 1, 12, 12, 12, 12, 1, 12, 1, 12, 12, 12, 12, ],
	[12, 12, 1, 12, 12, 12, 12, 12, 12, 12, 1, 1, 12, ],
	[12, 12, 1, 12, 12, 12, 12, 12, 12, 12, 1, 1, 12, ],
	[1, 1, 1, 1, 1, 1, 12, 12, 1, 1, 12, 12, 1, ],
	[1, 12, 12, 12, 1, 1, 12, 12, 1, 1, 12, 12, 1, ],
	[12, 12, 12, 12, 12, 12, 12, 12, 12, 12, 12, 12, 12, ],
	[1, 1, 12, 12, 1, 1, 12, 12, 1, 1, 12, 1, 1, ],
	[1, 1, 12, 12, 1, 1, 12, 12, 1, 1, 12, 1, 1, ],
]
