connections=[
		],
events={
	
		'exits':[{'name':'MT. CHIMNEY (24.12)','x':6,'y':11},{'name':'MT. CHIMNEY (24.12)','x':7,'y':11},		],
	
		'NPCs':[
			{'is_trainer':0,'b1':8,'b2':0,'sprite':'45','x':6,'y':6},
			{'is_trainer':0,'b1':1,'b2':0,'sprite':'114','x':6,'y':3},
		],
	
		'signs':[
		],
	
		'triggers':[
		],

},
partial_map=[
	[0, 1, 0, 1, 1, 0, 1, 0, 1, 1, 0, 1, 0, ],
	[1, 1, 1, 1, 1, 1, 1, 1, 1, 1, 1, 1, 1, ],
	[12, 12, 12, 12, 12, 12, 12, 12, 12, 12, 12, 12, 12, ],
	[1, 1, 1, 1, 1, 1, 1, 1, 1, 1, 1, 1, 1, ],
	[1, 1, 1, 1, 1, 1, 12, 1, 1, 1, 1, 1, 1, ],
	[1, 1, 1, 1, 1, 1, 12, 1, 1, 1, 1, 1, 1, ],
	[1, 1, 1, 1, 1, 1, 12, 1, 1, 1, 1, 1, 1, ],
	[12, 12, 12, 12, 12, 12, 12, 0, 12, 12, 12, 12, 1, ],
	[12, 12, 12, 12, 12, 12, 12, 12, 12, 12, 12, 12, 1, ],
	[12, 12, 12, 12, 12, 12, 12, 12, 12, 12, 12, 12, 1, ],
	[12, 12, 0, 0, 12, 12, 12, 12, 12, 0, 0, 12, 12, ],
	[12, 12, 12, 12, 12, 12, 0, 0, 12, 12, 12, 12, 12, ],
]
