connections=[
		],
events={
	{
		exits:[MT. PYRE (24.19),MT. PYRE (24.17),MT. PYRE (24.19),MT. PYRE (24.19),MT. PYRE (24.17),MT. PYRE (24.17),		]},
	{
		NPCs:[
			{is_trainer:1,b1:24,b2:0,sprite:40},
			{is_trainer:0,b1:1,b2:0,sprite:59},
		]},
	{
		signs:[
		]},
	{
		triggers:[
		]},

},
[
	[1, 1, 1, 1, 1, 1, 1, 1, 1, 1, 1, 1, 1, ],
	[1, 1, 1, 1, 1, 1, 1, 1, 1, 1, 12, 1, 1, ],
	[1, 1, 1, 1, 1, 1, 1, 1, 1, 12, 12, 12, 1, ],
	[1, 1, 1, 1, 1, 1, 1, 1, 1, 12, 12, 12, 1, ],
	[1, 1, 1, 1, 1, 1, 1, 1, 1, 12, 12, 12, 1, ],
	[1, 1, 12, 1, 1, 1, 1, 1, 1, 12, 12, 12, 1, ],
	[1, 12, 12, 12, 1, 1, 1, 1, 1, 12, 12, 12, 1, ],
	[1, 12, 12, 12, 1, 1, 1, 1, 1, 12, 12, 12, 12, ],
	[12, 12, 12, 12, 12, 12, 12, 12, 12, 12, 12, 12, 1, ],
	[1, 1, 1, 1, 1, 1, 1, 1, 1, 12, 12, 12, 1, ],
	[1, 12, 12, 13, 12, 12, 1, 1, 1, 12, 12, 12, 12, ],
	[1, 12, 12, 12, 12, 12, 1, 1, 1, 1, 1, 1, 1, ],
	[1, 12, 12, 12, 12, 12, 12, 12, 12, 12, 12, 12, 12, ],
]
