Connections;
Exits;MT. PYRE (24.21);MT. PYRE (24.21);MT. PYRE (24.21);
1 1 1 1 1 1 1 1 1 1 1 1 1 1 1 1 1 1 1 1 1 1 1 1 1 1 1 1 1 1 1 1 1 1 1 1 1 1 1 1 1 1 1 1 1 1 1 1 1 1 
1 1 1 1 1 1 1 1 1 1 1 1 1 1 1 1 1 1 1 1 1 1 1 1 1 1 1 1 1 1 1 1 1 1 1 1 1 1 1 1 1 1 1 1 1 1 1 1 1 1 
1 1 1 1 1 1 1 1 1 1 1 1 1 1 1 1 0 1 1 12 12 12 12 1 12 12 12 12 1 1 0 1 1 1 1 1 1 1 1 1 1 1 1 1 1 1 1 1 1 1 
1 1 1 1 1 1 1 1 1 1 1 1 1 1 1 1 1 1 1 12 12 12 1 12 1 12 12 12 1 1 1 1 1 1 1 1 1 1 1 1 1 1 1 1 1 1 1 1 1 1 
1 1 1 1 1 1 1 1 12 12 1 12 1 12 12 12 1 1 1 12 12 12 1 1 1 12 12 12 1 1 1 12 12 12 1 12 1 12 1 1 1 1 1 1 1 1 1 1 1 1 
1 1 1 1 1 1 1 1 12 12 12 12 12 12 12 12 1 1 1 12 12 12 12 12 12 12 12 12 1 1 1 12 12 12 12 12 12 12 1 1 1 1 12 12 12 1 1 1 1 1 
1 12 12 1 1 1 1 0 1 1 1 1 1 1 1 12 1 1 1 12 12 12 12 12 12 12 12 12 1 1 1 12 1 1 1 1 1 12 1 1 1 1 12 1 1 1 12 1 1 1 
1 1 1 1 1 1 1 1 1 1 1 1 1 1 1 12 1 1 0 1 1 12 12 12 12 12 1 1 0 1 1 12 1 1 1 1 1 12 1 1 1 1 12 1 1 1 12 1 1 1 
1 1 1 1 1 1 1 1 1 1 1 1 1 1 1 12 1 1 1 1 1 1 12 12 12 1 1 1 1 1 1 12 1 1 1 1 1 1 1 1 1 1 12 1 1 1 12 1 1 1 
1 1 1 1 1 1 1 1 1 1 1 12 1 1 1 12 1 12 12 12 12 12 12 12 12 12 12 12 12 12 1 12 1 1 1 1 1 1 1 1 1 1 12 1 1 1 12 1 1 1 
1 1 1 1 1 1 1 1 1 1 1 12 1 1 1 12 1 1 1 1 1 1 12 12 12 1 1 1 1 1 1 12 1 1 1 1 1 1 1 1 1 1 12 1 1 1 12 1 1 1 
1 1 1 1 1 1 1 1 12 1 1 12 1 1 1 12 12 12 12 12 12 12 12 12 12 12 12 12 12 12 12 12 1 1 1 1 1 12 12 1 1 1 12 1 1 1 12 1 1 1 
1 1 1 1 1 1 1 1 12 1 1 12 1 1 0 1 1 1 1 1 1 1 12 12 12 1 1 1 1 1 1 1 0 1 1 1 1 12 12 1 1 1 1 0 1 1 12 1 1 1 
1 1 1 1 1 1 1 1 12 1 1 12 1 1 1 1 1 1 1 1 1 1 12 12 12 1 1 1 1 1 1 1 1 1 1 1 1 12 12 1 1 1 1 1 1 1 12 1 1 1 
1 1 1 1 1 1 1 1 1 1 1 12 1 1 1 1 1 1 1 1 1 1 12 12 12 1 1 1 1 1 1 1 1 1 1 1 1 12 12 1 1 1 1 1 1 1 12 1 1 1 
1 12 12 1 12 12 12 12 1 1 0 1 1 1 1 1 1 1 1 1 12 12 12 12 12 12 12 1 1 1 1 1 1 1 1 0 0 1 1 1 1 1 1 1 1 12 12 1 1 1 
1 12 12 1 1 1 1 1 1 1 1 1 1 1 1 1 1 1 1 1 1 12 12 12 12 12 1 1 1 1 1 1 1 1 1 1 1 1 1 1 12 12 1 1 1 12 12 1 1 1 
1 1 12 1 1 1 1 1 1 1 1 1 1 1 1 1 1 1 1 1 1 1 12 12 12 1 1 1 1 1 1 1 1 1 1 1 1 1 1 1 12 12 1 1 1 12 12 1 1 1 
1 1 12 1 12 12 1 1 12 12 12 12 12 12 12 12 12 12 12 12 12 12 12 12 12 12 12 12 12 12 12 12 12 12 12 1 1 1 1 1 1 12 1 1 1 12 1 1 1 1 
1 1 12 1 1 1 1 0 1 12 12 1 1 1 1 1 1 1 1 1 1 12 12 12 12 12 1 1 1 12 12 12 12 12 1 1 1 1 1 1 1 1 1 12 12 12 1 1 1 1 
1 1 12 12 12 1 1 1 1 12 12 1 1 1 1 1 1 1 1 1 1 12 12 12 12 12 1 1 1 12 1 1 1 12 1 1 1 1 1 1 1 1 1 12 12 1 1 1 1 1 
1 1 1 12 12 1 12 1 1 12 12 12 1 1 1 1 1 12 1 1 1 12 12 12 12 12 1 1 1 12 1 1 1 12 12 12 12 12 12 1 1 12 1 12 12 1 1 1 1 1 
1 1 1 1 12 1 12 1 1 1 12 1 1 1 1 1 1 12 1 1 1 12 12 12 12 12 1 1 1 12 1 1 1 12 12 1 12 1 12 1 1 12 1 12 12 1 1 1 1 1 
1 1 1 1 12 1 1 1 1 12 12 12 1 1 1 1 1 12 1 1 1 12 12 12 12 12 1 1 1 1 12 12 12 12 12 12 12 12 12 1 1 12 1 12 1 1 1 1 1 1 
1 1 1 1 12 12 1 1 1 12 12 12 1 1 12 12 12 1 1 1 1 12 12 12 12 12 1 1 1 12 12 1 12 12 12 12 12 12 12 1 1 1 1 12 1 1 1 1 1 1 
1 1 1 1 12 12 1 1 1 1 12 1 1 1 12 1 12 12 1 1 1 12 12 12 12 12 1 1 1 12 1 1 1 12 12 1 12 1 12 1 1 1 12 12 1 1 1 1 1 1 
1 1 1 1 1 1 1 1 1 12 12 12 1 1 1 1 1 12 1 1 1 12 12 12 12 12 1 1 1 12 1 1 1 12 12 12 12 12 12 1 1 1 12 12 1 1 1 1 1 1 
1 1 1 1 1 1 1 1 0 1 1 1 0 1 1 1 1 12 1 1 1 12 12 12 12 12 1 1 1 12 1 1 1 1 1 1 1 1 1 0 1 1 12 12 1 1 1 1 1 1 
1 1 1 1 1 1 1 1 1 1 1 1 1 1 1 1 1 12 1 1 1 12 12 12 12 12 1 1 1 1 12 12 12 1 1 1 1 1 1 1 1 1 12 1 1 1 1 1 1 1 
1 1 1 1 1 1 1 1 12 12 12 12 12 12 12 12 12 1 1 1 1 12 12 12 12 12 1 1 1 12 12 1 12 12 12 12 12 12 12 12 12 1 12 1 1 1 1 1 1 1 
1 1 1 1 1 1 12 1 1 1 1 1 12 12 12 1 12 12 1 1 1 12 12 12 12 12 1 1 1 12 12 12 12 12 12 12 12 12 1 1 1 1 12 1 1 1 1 1 1 1 
1 1 1 1 1 1 12 12 12 12 12 1 1 1 1 1 1 1 1 1 1 1 12 12 12 1 1 1 1 1 1 1 1 1 1 1 1 1 1 12 12 12 12 1 1 1 1 1 1 1 
1 1 1 1 1 1 1 12 12 12 12 12 12 12 12 12 12 12 12 12 12 13 13 13 13 13 12 12 12 12 12 12 12 12 12 12 12 12 12 12 12 12 12 1 1 1 1 1 1 1 
1 1 1 1 1 1 1 1 12 12 12 12 12 1 12 12 12 1 12 12 12 1 13 13 13 1 12 12 12 1 12 12 12 1 12 12 12 12 12 12 12 12 1 1 1 1 1 1 1 1 
1 1 1 1 1 1 1 1 1 1 12 12 12 12 12 12 12 12 12 12 12 13 13 13 13 13 12 12 12 12 12 12 12 12 12 12 12 12 12 12 12 1 1 1 1 1 1 1 1 1 
1 1 1 1 1 1 1 1 1 1 12 12 12 1 12 12 12 1 12 12 12 13 13 13 13 13 12 12 12 1 12 12 12 1 12 12 12 12 12 12 12 1 1 1 1 1 1 1 1 1 
1 1 1 1 1 1 1 1 1 1 1 1 1 1 1 1 1 1 1 1 12 13 13 13 13 13 12 1 1 1 1 1 1 1 1 1 1 1 1 1 1 1 1 1 1 1 1 1 1 1 
