connections=[
		],
events={
	{
		exits:[MT. PYRE (24.19),MT. PYRE (24.19),		]},
	{
		NPCs:[
			{is_trainer:1,b1:23,b2:0,sprite:40},
			{is_trainer:0,b1:1,b2:0,sprite:59},
			{is_trainer:1,b1:24,b2:0,sprite:37},
		]},
	{
		signs:[
		]},
	{
		triggers:[
		]},

},
[
	[1, 1, 1, 1, 1, 1, 1, 1, 1, 1, 1, 1, 1, ],
	[1, 1, 12, 1, 1, 1, 1, 1, 1, 1, 1, 1, 1, ],
	[1, 12, 12, 12, 1, 1, 12, 12, 12, 12, 12, 12, 1, ],
	[12, 12, 12, 12, 1, 12, 12, 12, 12, 12, 12, 12, 12, ],
	[12, 12, 12, 1, 1, 12, 12, 12, 13, 12, 12, 12, 12, ],
	[1, 12, 12, 12, 12, 12, 12, 13, 13, 12, 12, 12, 1, ],
	[1, 1, 1, 1, 1, 1, 1, 1, 1, 1, 12, 1, 1, ],
	[1, 1, 1, 1, 1, 1, 1, 1, 1, 1, 12, 1, 1, ],
	[1, 12, 12, 1, 1, 12, 13, 12, 1, 1, 12, 12, 1, ],
	[12, 12, 12, 1, 12, 12, 12, 12, 12, 1, 12, 12, 12, ],
	[12, 12, 12, 12, 12, 12, 12, 12, 12, 12, 12, 12, 12, ],
	[12, 12, 12, 1, 12, 12, 12, 12, 12, 1, 12, 12, 12, ],
	[1, 12, 12, 1, 1, 12, 12, 12, 1, 1, 12, 12, 1, ],
]
