connections=[
		],
events={
	{
		exits:[MT. CHIMNEY (24.12),MT. CHIMNEY (24.12),		]},
	{
		NPCs:[
			{is_trainer:0,b1:8,b2:0,sprite:45},
			{is_trainer:0,b1:1,b2:0,sprite:114},
		]},
	{
		signs:[
		]},
	{
		triggers:[
		]},

},
[
	[0, 1, 0, 1, 1, 0, 1, 0, 1, 1, 0, 1, 0, ],
	[1, 1, 1, 1, 1, 1, 1, 1, 1, 1, 1, 1, 1, ],
	[12, 12, 12, 12, 12, 12, 12, 12, 12, 12, 12, 12, 12, ],
	[1, 1, 1, 1, 1, 1, 1, 1, 1, 1, 1, 1, 1, ],
	[1, 1, 1, 1, 1, 1, 12, 1, 1, 1, 1, 1, 1, ],
	[1, 1, 1, 1, 1, 1, 12, 1, 1, 1, 1, 1, 1, ],
	[1, 1, 1, 1, 1, 1, 12, 1, 1, 1, 1, 1, 1, ],
	[12, 12, 12, 12, 12, 12, 12, 0, 12, 12, 12, 12, 1, ],
	[12, 12, 12, 12, 12, 12, 12, 12, 12, 12, 12, 12, 1, ],
	[12, 12, 12, 12, 12, 12, 12, 12, 12, 12, 12, 12, 1, ],
	[12, 12, 0, 0, 12, 12, 12, 12, 12, 0, 0, 12, 12, ],
	[12, 12, 12, 12, 12, 12, 0, 0, 12, 12, 12, 12, 12, ],
]
