Connections;
Exits;MT. CHIMNEY (19.1);MT. CHIMNEY (19.1);JAGGED PASS (24.13);JAGGED PASS (24.13);
1 1 1 1 1 1 1 1 1 1 1 1 1 12 1 1 1 1 1 1 12 1 1 0 1 1 1 1 1 1 1 1 1 1 1 1 1 1 1 1 
1 1 1 1 1 1 1 1 1 1 1 1 1 1 1 1 1 1 1 1 1 1 1 1 1 1 13 1 1 1 1 1 1 1 1 1 1 1 1 1 
1 1 1 1 1 1 1 1 1 1 1 1 1 1 1 1 1 1 1 1 1 1 1 1 1 1 1 1 1 1 1 1 1 1 1 1 1 1 1 1 
1 1 1 1 1 1 1 1 1 1 1 1 1 1 1 1 1 1 1 1 1 1 1 1 1 1 1 1 1 1 1 1 1 1 1 1 1 1 1 1 
1 1 1 1 1 1 1 1 1 1 1 1 1 1 1 1 1 1 1 1 1 1 1 1 1 1 1 1 1 1 1 1 1 1 1 1 1 1 1 1 
1 1 1 1 1 1 1 1 1 1 1 1 1 1 1 1 1 1 1 1 1 1 1 1 1 1 1 1 1 12 12 12 12 1 1 1 1 1 1 1 
1 1 1 1 1 1 1 1 1 1 12 12 12 12 13 1 1 1 1 1 1 1 1 1 1 1 1 1 1 12 12 12 12 1 1 1 1 1 1 1 
1 1 1 1 1 1 1 12 12 12 12 12 12 12 12 1 1 1 1 1 1 1 1 1 1 1 1 1 1 12 12 12 12 1 1 1 1 1 1 1 
1 1 1 1 1 1 1 12 12 12 12 1 1 1 1 1 1 1 1 1 1 1 1 1 1 1 1 1 1 12 12 12 12 1 1 1 1 1 1 1 
1 1 1 1 1 1 1 12 12 12 12 1 1 1 1 1 1 1 1 1 1 1 1 1 1 1 1 1 1 12 12 12 1 1 1 1 1 1 1 1 
1 1 1 1 1 1 1 1 1 1 12 1 1 1 1 1 1 1 1 1 1 1 1 1 1 1 1 1 12 12 12 12 1 1 1 1 1 1 1 1 
1 1 1 1 1 1 1 1 1 1 12 12 12 1 1 1 1 1 1 1 1 1 1 1 1 1 1 12 12 12 12 12 1 1 1 1 1 1 1 1 
1 1 1 1 1 1 1 1 1 1 12 12 12 12 12 1 1 1 1 1 1 1 1 1 1 13 1 12 12 12 12 12 1 1 1 1 1 1 1 1 
1 1 1 1 1 1 1 1 12 12 12 12 1 1 1 1 1 1 1 1 1 1 1 1 13 13 1 12 12 12 12 12 1 1 1 1 1 1 1 1 
1 1 1 1 1 1 1 1 1 12 12 12 1 1 1 12 12 1 1 1 1 1 1 12 12 12 12 12 12 12 12 12 1 1 1 1 1 1 1 1 
1 1 1 1 1 1 1 1 1 12 12 12 1 1 1 12 12 12 12 12 12 12 12 12 12 12 12 12 12 12 12 12 1 1 1 1 1 1 1 1 
1 1 1 1 1 1 1 1 1 12 12 12 12 12 12 12 12 12 12 12 12 12 12 12 12 12 12 12 12 12 12 1 1 1 1 1 1 1 1 1 
1 1 1 1 1 1 1 1 1 1 12 12 12 12 12 12 12 12 12 12 12 12 12 12 12 12 12 12 12 12 12 1 13 1 1 1 1 1 1 1 
1 1 1 1 1 1 1 1 1 1 1 1 12 12 12 12 12 12 12 12 12 12 12 12 12 12 12 12 12 12 12 1 13 1 1 1 1 1 1 1 
1 1 1 1 1 1 1 1 1 1 1 1 12 12 12 12 12 12 12 12 12 12 12 12 12 12 12 12 12 12 1 1 13 1 1 1 1 1 1 1 
1 1 1 1 1 1 1 1 1 1 1 1 1 1 12 12 12 12 12 12 12 12 12 12 12 12 12 12 12 1 1 13 13 1 1 1 1 1 1 1 
1 1 1 1 1 1 1 1 1 1 1 13 13 1 1 12 12 12 12 12 12 12 12 12 12 12 12 12 1 1 1 1 1 1 1 1 1 1 1 1 
1 1 1 1 1 1 1 1 1 1 1 1 1 12 1 1 1 12 12 1 1 1 1 1 1 12 1 1 1 1 1 1 1 1 1 1 1 1 1 1 
1 1 1 1 1 1 1 1 1 1 1 1 1 1 1 1 1 1 1 1 12 12 12 12 12 12 1 1 1 1 1 1 1 1 1 1 1 1 1 1 
1 1 1 1 1 1 1 1 1 1 1 1 1 1 13 1 1 12 12 1 12 1 1 1 1 1 1 12 12 1 1 1 1 1 1 1 1 1 1 1 
1 1 1 1 1 1 1 1 1 1 1 1 1 1 1 1 1 1 1 1 12 12 12 12 12 12 12 12 12 1 1 1 1 1 1 1 1 1 1 1 
1 1 1 1 1 1 1 1 1 1 1 1 1 1 1 1 1 1 12 12 12 12 12 12 12 12 12 1 1 1 1 12 1 12 1 1 1 12 1 1 
1 1 1 1 1 1 1 1 1 1 1 1 1 1 1 1 1 1 1 12 12 12 1 1 1 1 12 1 1 1 1 1 1 1 1 1 1 1 1 1 
1 1 1 1 1 12 1 1 13 1 1 1 1 1 1 1 1 1 1 1 1 1 1 12 12 12 12 1 1 12 12 1 13 1 1 1 1 1 1 1 
1 1 1 1 1 1 1 1 1 1 1 1 1 1 1 1 1 1 1 1 1 1 1 1 1 1 12 1 12 12 12 1 1 1 1 1 12 12 13 12 
1 1 1 1 1 13 13 1 1 1 1 1 1 1 1 1 1 1 1 1 1 1 1 12 12 12 12 12 12 12 12 1 1 1 1 1 13 1 1 13 
1 1 1 1 1 1 1 1 1 1 12 1 1 1 1 1 1 1 1 1 1 1 1 12 12 12 12 12 1 1 1 1 1 13 1 12 12 1 1 1 
1 1 1 1 1 1 1 1 1 1 12 1 1 1 12 12 12 12 12 12 12 12 1 1 1 1 12 1 1 12 12 12 1 1 1 1 13 1 12 1 
1 1 1 1 1 1 1 1 1 1 12 12 1 1 12 13 1 1 1 1 12 12 12 12 12 12 12 12 12 12 12 1 1 1 12 13 1 1 1 12 
1 1 1 1 1 1 1 1 1 1 13 1 1 1 1 1 1 1 1 1 12 12 12 12 12 12 12 12 12 12 12 1 12 1 13 1 1 12 13 13 
1 1 1 1 1 1 12 1 1 1 1 13 12 1 1 1 1 1 1 1 12 12 12 12 12 12 12 12 13 12 12 1 0 1 1 1 1 13 1 1 
1 1 1 1 1 1 1 1 1 1 1 1 1 1 1 1 1 0 0 1 12 12 12 12 12 12 12 12 12 12 12 1 1 1 0 1 1 1 1 13 
1 1 12 1 1 1 13 13 1 1 1 1 1 1 12 12 12 12 12 12 12 12 12 12 13 12 12 12 12 12 12 1 1 1 1 1 0 1 1 1 
1 12 1 12 1 1 1 1 1 1 13 1 13 1 13 13 12 12 12 12 12 12 12 12 12 12 12 12 13 13 1 1 1 1 12 1 1 1 1 1 
1 13 13 1 1 1 1 1 12 1 1 1 1 1 1 1 1 1 1 12 12 12 12 1 1 1 1 1 1 1 1 1 1 1 13 1 12 1 1 1 
1 1 1 13 13 1 1 1 1 1 1 1 1 1 1 1 12 12 1 12 12 12 12 1 12 12 12 12 1 1 1 1 13 13 1 1 1 1 1 1 
1 1 1 1 1 1 1 1 13 1 1 13 13 1 1 1 1 13 1 1 12 12 1 1 13 1 1 1 1 1 1 12 12 12 1 12 13 1 1 1 
1 13 13 1 1 12 1 1 1 12 1 1 1 1 13 1 12 1 1 1 13 13 1 1 1 12 12 13 1 1 12 13 1 1 1 12 1 1 1 1 
1 1 1 1 1 1 1 1 1 13 13 13 1 1 1 1 1 1 1 1 13 13 1 1 1 1 1 13 1 12 12 1 1 1 12 12 1 12 1 1 
12 12 1 12 1 1 1 1 1 1 1 1 1 1 1 1 1 1 1 1 1 1 1 1 1 1 1 1 1 12 12 1 12 1 1 12 1 12 1 1 
1 1 1 1 1 1 12 1 13 1 13 1 13 1 1 13 1 1 1 1 1 1 1 1 1 1 1 1 12 1 1 1 12 13 13 12 1 1 1 1 
1 1 1 1 1 13 1 1 1 1 1 1 1 1 1 1 13 1 1 1 1 1 1 1 1 1 1 1 1 1 13 1 1 12 12 1 1 1 1 1 
