connections=[
		],
events={
	
		'exits':[{'name':'MT. PYRE (24.16)','x':10,'y':1},{'name':'MT. PYRE (24.18)','x':2,'y':1},{'name':'MT. PYRE (24.18)','x':9,'y':10},{'name':'MT. PYRE (24.18)','x':1,'y':12},{'name':'MT. PYRE (24.16)','x':10,'y':12},{'name':'MT. PYRE (24.16)','x':6,'y':12},		],
	
		'NPCs':[
			{'is_trainer':1,'b1':18,'b2':0,'sprite':'37','x':1,'y':4},
			{'is_trainer':1,'b1':17,'b2':0,'sprite':'47','x':11,'y':4},
			{'is_trainer':0,'b1':1,'b2':0,'sprite':'59','x':0,'y':7},
			{'is_trainer':1,'b1':14,'b2':0,'sprite':'20','x':6,'y':4},
		],
	
		'signs':[
		],
	
		'triggers':[
		],

},
partial_map=[
	[1, 1, 1, 1, 1, 1, 1, 1, 1, 1, 1, 1, 1, ],
	[1, 1, 12, 1, 1, 1, 1, 1, 1, 1, 12, 1, 1, ],
	[1, 12, 12, 12, 12, 1, 1, 1, 12, 12, 12, 12, 1, ],
	[1, 12, 12, 12, 1, 1, 1, 1, 1, 12, 12, 12, 1, ],
	[12, 12, 12, 12, 12, 12, 12, 12, 12, 12, 12, 12, 12, ],
	[1, 12, 12, 12, 12, 12, 1, 12, 12, 12, 12, 12, 1, ],
	[1, 12, 12, 1, 1, 1, 1, 1, 1, 1, 12, 12, 1, ],
	[12, 12, 12, 12, 12, 12, 12, 12, 12, 12, 12, 12, 12, ],
	[1, 1, 1, 1, 1, 1, 1, 1, 1, 1, 12, 12, 12, ],
	[1, 1, 1, 1, 1, 1, 1, 1, 1, 1, 12, 12, 12, ],
	[12, 12, 12, 12, 12, 12, 12, 1, 1, 12, 12, 12, 12, ],
	[12, 12, 12, 1, 1, 12, 12, 1, 1, 12, 12, 1, 1, ],
	[12, 12, 12, 1, 1, 12, 12, 1, 1, 12, 12, 1, 1, ],
]
