connections=[
		],
events={
	
		'exits':[{'name':'NAVEL ROCK (26.71)','x':4,'y':6},{'name':'NAVEL ROCK (26.69)','x':11,'y':79},{'name':'NAVEL ROCK (26.76)','x':22,'y':6},		],
	
		'NPCs':[
		],
	
		'signs':[
		],
	
		'triggers':[
		],

},
partial_map=[
	[0, 0, 0, 0, 0, 0, 0, 0, 0, 0, 0, 0, 0, 0, 0, 0, 0, 0, 0, 0, 0, 0, 0, 0, 0, 0, 0, ],
	[0, 0, 0, 0, 0, 0, 0, 0, 0, 0, 0, 0, 0, 0, 0, 0, 0, 0, 0, 0, 0, 0, 0, 0, 0, 0, 0, ],
	[0, 0, 0, 0, 0, 0, 0, 0, 0, 0, 0, 0, 0, 0, 0, 0, 0, 0, 0, 0, 0, 0, 0, 0, 0, 0, 0, ],
	[0, 0, 0, 0, 0, 0, 0, 0, 0, 0, 0, 0, 0, 0, 0, 0, 0, 0, 0, 0, 0, 0, 0, 0, 0, 0, 0, ],
	[0, 1, 1, 1, 1, 1, 1, 1, 1, 1, 1, 1, 1, 1, 1, 1, 1, 1, 1, 1, 1, 1, 1, 1, 1, 1, 0, ],
	[0, 1, 1, 1, 1, 1, 1, 1, 1, 1, 1, 1, 1, 1, 1, 1, 1, 1, 1, 1, 1, 1, 1, 1, 1, 1, 0, ],
	[0, 1, 1, 12, 12, 12, 12, 12, 12, 12, 12, 12, 12, 12, 12, 12, 12, 12, 12, 12, 12, 12, 12, 12, 1, 1, 0, ],
	[0, 1, 1, 12, 12, 12, 12, 12, 12, 12, 12, 12, 12, 12, 12, 12, 12, 12, 12, 12, 12, 12, 12, 12, 1, 1, 0, ],
	[0, 1, 1, 12, 12, 12, 12, 12, 12, 12, 12, 12, 12, 12, 12, 12, 12, 12, 12, 12, 12, 12, 12, 12, 1, 1, 0, ],
	[0, 1, 1, 1, 1, 1, 1, 1, 1, 1, 1, 1, 12, 12, 12, 1, 1, 1, 1, 1, 1, 1, 1, 1, 1, 1, 0, ],
	[0, 0, 0, 0, 0, 0, 0, 0, 0, 0, 0, 1, 1, 0, 1, 1, 0, 0, 0, 0, 0, 0, 0, 0, 0, 0, 0, ],
	[0, 0, 0, 0, 0, 0, 0, 0, 0, 0, 0, 1, 1, 12, 1, 1, 0, 0, 0, 0, 0, 0, 0, 0, 0, 0, 0, ],
	[0, 0, 0, 0, 0, 0, 0, 0, 0, 0, 0, 1, 1, 12, 1, 1, 0, 0, 0, 0, 0, 0, 0, 0, 0, 0, 0, ],
	[0, 0, 0, 0, 0, 0, 0, 0, 0, 0, 0, 1, 1, 12, 1, 1, 0, 0, 0, 0, 0, 0, 0, 0, 0, 0, 0, ],
	[0, 1, 1, 1, 1, 1, 0, 0, 0, 0, 0, 1, 1, 12, 1, 1, 0, 0, 0, 0, 0, 1, 1, 1, 1, 1, 0, ],
	[0, 1, 1, 1, 1, 1, 0, 0, 0, 0, 0, 1, 1, 12, 1, 1, 0, 0, 0, 0, 0, 1, 1, 1, 1, 1, 0, ],
	[0, 1, 1, 12, 1, 1, 0, 0, 0, 0, 0, 1, 1, 12, 1, 1, 0, 0, 0, 0, 0, 1, 1, 12, 1, 1, 0, ],
	[0, 1, 1, 12, 1, 1, 0, 0, 0, 0, 0, 1, 1, 12, 1, 1, 0, 0, 0, 0, 0, 1, 1, 12, 1, 1, 0, ],
	[0, 1, 1, 12, 1, 1, 0, 0, 0, 0, 0, 1, 1, 12, 1, 1, 0, 0, 0, 0, 0, 1, 1, 12, 1, 1, 0, ],
	[0, 1, 1, 12, 1, 1, 0, 0, 0, 0, 0, 1, 1, 12, 1, 1, 0, 0, 0, 0, 0, 1, 1, 12, 1, 1, 0, ],
	[0, 1, 1, 12, 1, 1, 0, 0, 0, 0, 0, 1, 1, 12, 1, 1, 0, 0, 0, 0, 0, 1, 1, 12, 1, 1, 0, ],
	[0, 1, 1, 12, 1, 1, 0, 0, 0, 0, 0, 1, 1, 12, 1, 1, 0, 0, 0, 0, 0, 1, 1, 12, 1, 1, 0, ],
	[0, 1, 1, 12, 1, 1, 0, 0, 0, 0, 0, 1, 1, 12, 1, 1, 0, 0, 0, 0, 0, 1, 1, 12, 1, 1, 0, ],
	[0, 1, 1, 12, 1, 1, 0, 0, 0, 0, 0, 1, 1, 12, 1, 1, 0, 0, 0, 0, 0, 1, 1, 12, 1, 1, 0, ],
	[0, 1, 1, 0, 1, 1, 0, 0, 0, 0, 0, 1, 1, 12, 1, 1, 0, 0, 0, 0, 0, 1, 1, 12, 1, 1, 0, ],
	[0, 1, 1, 0, 1, 1, 0, 0, 0, 0, 0, 1, 1, 12, 1, 1, 0, 0, 0, 0, 0, 1, 1, 12, 1, 1, 0, ],
	[0, 1, 1, 0, 1, 1, 0, 0, 0, 0, 0, 1, 1, 0, 1, 1, 0, 0, 0, 0, 0, 1, 1, 12, 1, 1, 0, ],
	[0, 1, 1, 12, 1, 1, 0, 0, 0, 0, 0, 1, 1, 0, 1, 1, 0, 0, 0, 0, 0, 1, 1, 12, 1, 1, 0, ],
	[0, 1, 1, 12, 1, 1, 0, 0, 0, 0, 0, 1, 1, 0, 1, 1, 0, 0, 0, 0, 0, 1, 1, 12, 1, 1, 0, ],
	[0, 1, 1, 12, 1, 1, 0, 0, 0, 0, 0, 1, 1, 0, 1, 1, 0, 0, 0, 0, 0, 1, 1, 12, 1, 1, 0, ],
	[0, 1, 1, 12, 1, 1, 0, 0, 0, 0, 0, 1, 1, 0, 1, 1, 0, 0, 0, 0, 0, 1, 1, 12, 1, 1, 0, ],
	[0, 1, 1, 12, 1, 1, 0, 0, 0, 0, 0, 1, 1, 0, 1, 1, 0, 0, 0, 0, 0, 1, 1, 12, 1, 1, 0, ],
	[0, 1, 1, 12, 1, 1, 0, 0, 0, 0, 0, 1, 1, 0, 1, 1, 0, 0, 0, 0, 0, 1, 1, 12, 1, 1, 0, ],
	[0, 1, 1, 12, 1, 1, 0, 0, 0, 0, 0, 1, 1, 0, 1, 1, 0, 0, 0, 0, 0, 1, 1, 12, 1, 1, 0, ],
	[0, 1, 1, 12, 1, 1, 0, 0, 0, 0, 0, 1, 1, 0, 1, 1, 1, 1, 1, 1, 1, 1, 1, 12, 1, 1, 0, ],
	[0, 1, 1, 12, 1, 1, 0, 0, 0, 0, 0, 1, 1, 0, 1, 1, 1, 1, 1, 1, 1, 1, 1, 12, 1, 1, 0, ],
	[0, 1, 1, 12, 1, 1, 0, 0, 0, 0, 0, 1, 1, 12, 12, 12, 12, 12, 12, 12, 12, 12, 12, 12, 1, 1, 0, ],
	[0, 1, 1, 12, 1, 1, 0, 0, 0, 0, 0, 1, 1, 12, 12, 1, 1, 1, 1, 1, 1, 1, 1, 1, 1, 1, 0, ],
	[0, 1, 1, 12, 1, 1, 0, 0, 0, 0, 0, 1, 1, 12, 1, 1, 0, 0, 0, 0, 0, 0, 0, 0, 0, 0, 0, ],
	[0, 1, 1, 12, 1, 1, 0, 0, 0, 0, 0, 1, 1, 12, 1, 1, 0, 0, 0, 0, 0, 0, 0, 0, 0, 0, 0, ],
	[0, 1, 1, 12, 1, 1, 0, 0, 0, 0, 0, 1, 1, 12, 1, 1, 0, 0, 0, 0, 0, 0, 0, 0, 0, 0, 0, ],
	[0, 1, 1, 12, 1, 1, 0, 0, 0, 0, 0, 1, 1, 12, 1, 1, 0, 0, 0, 0, 0, 0, 0, 0, 0, 0, 0, ],
	[0, 1, 1, 12, 1, 1, 0, 0, 0, 0, 0, 1, 1, 12, 1, 1, 0, 0, 0, 0, 0, 0, 0, 0, 0, 0, 0, ],
	[0, 1, 1, 12, 1, 1, 0, 0, 0, 0, 0, 1, 1, 12, 1, 1, 0, 0, 0, 0, 0, 0, 0, 0, 0, 0, 0, ],
	[0, 1, 1, 12, 1, 1, 0, 0, 0, 0, 0, 1, 1, 12, 1, 1, 0, 0, 0, 0, 0, 0, 0, 0, 0, 0, 0, ],
	[0, 1, 1, 12, 1, 1, 1, 1, 1, 1, 1, 1, 1, 12, 1, 1, 0, 0, 0, 0, 0, 0, 0, 0, 0, 0, 0, ],
	[0, 1, 1, 12, 1, 1, 1, 1, 1, 1, 1, 1, 1, 12, 1, 1, 0, 0, 0, 0, 0, 0, 0, 0, 0, 0, 0, ],
	[0, 1, 1, 12, 12, 12, 12, 12, 12, 12, 12, 12, 12, 12, 1, 1, 0, 0, 0, 0, 0, 0, 0, 0, 0, 0, 0, ],
	[0, 1, 1, 1, 1, 1, 1, 1, 1, 1, 1, 1, 12, 12, 1, 1, 0, 0, 0, 0, 0, 0, 0, 0, 0, 0, 0, ],
	[0, 0, 0, 0, 0, 0, 0, 0, 0, 0, 0, 1, 1, 12, 1, 1, 0, 0, 0, 0, 0, 0, 0, 0, 0, 0, 0, ],
	[0, 0, 0, 0, 0, 0, 0, 0, 0, 0, 0, 1, 1, 12, 1, 1, 0, 0, 0, 0, 0, 0, 0, 0, 0, 0, 0, ],
	[0, 0, 0, 0, 0, 0, 0, 0, 0, 0, 0, 1, 1, 12, 1, 1, 0, 0, 0, 0, 0, 0, 0, 0, 0, 0, 0, ],
	[0, 0, 0, 0, 0, 0, 0, 0, 0, 0, 0, 1, 1, 12, 1, 1, 0, 0, 0, 0, 0, 0, 0, 0, 0, 0, 0, ],
	[0, 0, 0, 0, 0, 0, 0, 0, 0, 0, 0, 1, 1, 12, 1, 1, 0, 0, 0, 0, 0, 0, 0, 0, 0, 0, 0, ],
	[0, 0, 0, 0, 0, 0, 0, 0, 0, 0, 0, 1, 1, 12, 1, 1, 0, 0, 0, 0, 0, 0, 0, 0, 0, 0, 0, ],
	[0, 0, 0, 0, 0, 0, 0, 0, 0, 0, 0, 1, 1, 12, 1, 1, 0, 0, 0, 0, 0, 0, 0, 0, 0, 0, 0, ],
	[0, 0, 0, 0, 0, 0, 0, 0, 0, 0, 0, 1, 1, 12, 1, 1, 0, 0, 0, 0, 0, 0, 0, 0, 0, 0, 0, ],
	[0, 0, 0, 0, 0, 0, 0, 0, 0, 0, 0, 1, 1, 12, 1, 1, 0, 0, 0, 0, 0, 0, 0, 0, 0, 0, 0, ],
	[0, 0, 0, 0, 0, 0, 0, 0, 0, 0, 0, 1, 1, 12, 1, 1, 0, 0, 0, 0, 0, 0, 0, 0, 0, 0, 0, ],
	[0, 0, 0, 0, 0, 0, 0, 0, 0, 0, 0, 1, 1, 12, 1, 1, 0, 0, 0, 0, 0, 0, 0, 0, 0, 0, 0, ],
	[0, 0, 0, 0, 0, 0, 0, 0, 0, 0, 0, 1, 1, 12, 1, 1, 0, 0, 0, 0, 0, 0, 0, 0, 0, 0, 0, ],
	[0, 0, 0, 0, 0, 0, 0, 0, 0, 0, 0, 1, 1, 12, 1, 1, 0, 0, 0, 0, 0, 0, 0, 0, 0, 0, 0, ],
	[0, 0, 0, 0, 0, 0, 0, 0, 0, 0, 0, 1, 1, 12, 1, 1, 0, 0, 0, 0, 0, 0, 0, 0, 0, 0, 0, ],
	[0, 0, 0, 0, 0, 0, 0, 0, 0, 0, 0, 1, 1, 12, 1, 1, 0, 0, 0, 0, 0, 0, 0, 0, 0, 0, 0, ],
	[0, 0, 0, 0, 0, 0, 0, 0, 0, 0, 0, 1, 1, 12, 1, 1, 0, 0, 0, 0, 0, 0, 0, 0, 0, 0, 0, ],
	[0, 0, 0, 0, 0, 0, 0, 0, 0, 0, 0, 1, 1, 12, 1, 1, 0, 0, 0, 0, 0, 0, 0, 0, 0, 0, 0, ],
	[0, 0, 0, 0, 0, 0, 0, 0, 0, 0, 0, 1, 1, 12, 1, 1, 0, 0, 0, 0, 0, 0, 0, 0, 0, 0, 0, ],
	[0, 0, 0, 0, 0, 0, 0, 0, 0, 0, 0, 1, 1, 12, 1, 1, 0, 0, 0, 0, 0, 0, 0, 0, 0, 0, 0, ],
	[0, 0, 0, 0, 0, 0, 0, 0, 0, 0, 0, 1, 1, 12, 1, 1, 0, 0, 0, 0, 0, 0, 0, 0, 0, 0, 0, ],
	[0, 0, 0, 0, 0, 0, 0, 0, 0, 0, 0, 1, 1, 12, 1, 1, 0, 0, 0, 0, 0, 0, 0, 0, 0, 0, 0, ],
	[0, 0, 0, 0, 0, 0, 0, 0, 0, 0, 0, 1, 1, 12, 1, 1, 0, 0, 0, 0, 0, 0, 0, 0, 0, 0, 0, ],
	[0, 0, 0, 0, 0, 0, 0, 0, 0, 0, 0, 1, 1, 12, 1, 1, 0, 0, 0, 0, 0, 0, 0, 0, 0, 0, 0, ],
	[0, 0, 0, 0, 0, 0, 0, 0, 0, 0, 0, 1, 1, 12, 1, 1, 0, 0, 0, 0, 0, 0, 0, 0, 0, 0, 0, ],
	[0, 0, 0, 0, 0, 0, 0, 0, 0, 0, 0, 1, 1, 12, 1, 1, 0, 0, 0, 0, 0, 0, 0, 0, 0, 0, 0, ],
	[0, 0, 0, 0, 0, 0, 0, 0, 0, 0, 0, 1, 1, 12, 1, 1, 0, 0, 0, 0, 0, 0, 0, 0, 0, 0, 0, ],
	[0, 0, 0, 0, 0, 0, 0, 0, 0, 0, 0, 1, 1, 12, 1, 1, 0, 0, 0, 0, 0, 0, 0, 0, 0, 0, 0, ],
	[0, 0, 0, 0, 0, 0, 0, 0, 0, 0, 0, 1, 1, 12, 1, 1, 0, 0, 0, 0, 0, 0, 0, 0, 0, 0, 0, ],
	[0, 0, 0, 0, 0, 0, 0, 0, 0, 1, 1, 1, 1, 12, 1, 1, 1, 1, 0, 0, 0, 0, 0, 0, 0, 0, 0, ],
	[0, 0, 0, 0, 0, 0, 0, 0, 0, 1, 1, 1, 1, 12, 1, 1, 1, 1, 0, 0, 0, 0, 0, 0, 0, 0, 0, ],
	[0, 0, 0, 0, 0, 0, 0, 0, 0, 1, 1, 12, 12, 12, 12, 12, 1, 1, 0, 0, 0, 0, 0, 0, 0, 0, 0, ],
	[0, 0, 0, 0, 0, 0, 0, 0, 0, 1, 1, 12, 12, 12, 12, 12, 1, 1, 0, 0, 0, 0, 0, 0, 0, 0, 0, ],
	[0, 0, 0, 0, 0, 0, 0, 0, 0, 1, 1, 12, 12, 12, 12, 12, 1, 1, 0, 0, 0, 0, 0, 0, 0, 0, 0, ],
	[0, 0, 0, 0, 0, 0, 0, 0, 0, 1, 1, 12, 12, 12, 12, 12, 1, 1, 0, 0, 0, 0, 0, 0, 0, 0, 0, ],
	[0, 0, 0, 0, 0, 0, 0, 0, 0, 1, 1, 12, 12, 12, 12, 12, 1, 1, 0, 0, 0, 0, 0, 0, 0, 0, 0, ],
	[0, 0, 0, 0, 0, 0, 0, 0, 0, 1, 1, 1, 1, 1, 1, 1, 1, 1, 0, 0, 0, 0, 0, 0, 0, 0, 0, ],
	[0, 0, 0, 0, 0, 0, 0, 0, 0, 1, 1, 1, 1, 1, 1, 1, 1, 1, 0, 0, 0, 0, 0, 0, 0, 0, 0, ],
]
