connections=[
		],
events={
	{
		exits:[NAVEL ROCK (26.82),NAVEL ROCK (26.84),		]},
	{
		NPCs:[
		]},
	{
		signs:[
		]},
	{
		triggers:[
		]},

},
[
	[0, 0, 0, 0, 0, 0, 0, 0, 0, ],
	[0, 1, 1, 1, 1, 1, 1, 1, 0, ],
	[0, 1, 1, 1, 1, 1, 1, 1, 0, ],
	[0, 1, 1, 12, 12, 1, 1, 1, 0, ],
	[0, 1, 1, 12, 12, 1, 1, 1, 0, ],
	[0, 1, 1, 12, 12, 0, 1, 1, 0, ],
	[0, 1, 1, 1, 1, 1, 1, 1, 0, ],
	[0, 1, 1, 1, 1, 1, 1, 1, 0, ],
]
