Connections;
Exits;NAVEL ROCK (26.84);NAVEL ROCK (26.86);
0 0 0 0 0 0 0 0 0 
0 1 1 1 1 1 1 1 0 
0 1 1 1 1 1 1 1 0 
0 1 1 12 12 1 1 1 0 
0 1 1 12 12 1 1 1 0 
0 1 1 12 12 0 1 1 0 
0 1 1 1 1 1 1 1 0 
0 1 1 1 1 1 1 1 0 
