connections=[
		],
events={
	
		'exits':[{'name':'NAVEL ROCK (26.71)','x':3,'y':3},{'name':'NAVEL ROCK (26.73)','x':5,'y':5},		],
	
		'NPCs':[
		],
	
		'signs':[
		],
	
		'triggers':[
		],

},
partial_map=[
	[0, 0, 0, 0, 0, 0, 0, 0, 0, ],
	[0, 1, 1, 1, 1, 1, 1, 1, 0, ],
	[0, 1, 1, 1, 1, 1, 1, 1, 0, ],
	[0, 1, 1, 12, 12, 1, 1, 1, 0, ],
	[0, 1, 1, 12, 12, 1, 1, 1, 0, ],
	[0, 1, 1, 12, 12, 0, 1, 1, 0, ],
	[0, 1, 1, 1, 1, 1, 1, 1, 0, ],
	[0, 1, 1, 1, 1, 1, 1, 1, 0, ],
]
