Connections;
Exits;NAVEL ROCK (26.68);NAVEL ROCK (26.70);
0 0 0 0 0 0 0 0 0 0 0 0 0 0 0 0 0 0 0 0 0 0 0 
0 1 1 1 1 1 1 1 1 1 1 1 1 1 1 1 1 1 1 1 1 1 0 
0 1 1 1 1 1 1 1 1 1 1 1 1 1 1 1 1 1 1 1 1 1 0 
0 1 1 12 12 12 12 12 12 12 12 12 12 12 12 12 12 12 12 12 1 1 0 
0 1 1 12 12 12 12 12 12 12 12 12 12 12 12 12 12 12 12 12 1 1 0 
0 1 1 12 12 12 12 12 12 12 12 12 12 12 12 12 12 12 12 12 1 1 0 
0 1 1 12 12 12 12 12 12 12 12 12 12 12 12 12 12 12 12 12 1 1 0 
0 1 1 12 12 12 12 12 12 12 12 12 12 12 12 12 12 12 12 12 1 1 0 
0 1 1 12 12 12 12 12 12 12 12 12 12 12 12 12 12 12 12 12 1 1 0 
0 1 1 12 12 12 12 12 12 12 12 12 12 12 12 12 12 12 12 12 1 1 0 
0 1 1 1 1 1 1 1 1 1 1 1 1 1 1 1 1 1 1 1 1 1 0 
