Connections;
Exits;ROUTE 110 (0.25);NEW MAUVILLE (24.53);
1 1 1 1 1 1 1 1 1 
1 1 1 1 12 1 1 1 1 
1 1 12 12 12 12 12 1 1 
1 1 12 12 12 12 12 1 1 
1 1 12 12 12 12 12 1 1 
1 1 12 12 12 12 12 1 1 
1 1 12 12 12 12 12 1 1 
1 1 1 1 1 1 1 1 1 
1 1 1 1 1 1 1 1 1 
