connections=[
		],
events={
	{
		exits:[ROUTE 110 (0.25),NEW MAUVILLE (24.53),		]},
	{
		NPCs:[
		]},
	{
		signs:[
		]},
	{
		triggers:[
			{x:4,y:2,flag:16570,scriptPointer:2323199},
		]},

},
[
	[1, 1, 1, 1, 1, 1, 1, 1, 1, ],
	[1, 1, 1, 1, 12, 1, 1, 1, 1, ],
	[1, 1, 12, 12, 12, 12, 12, 1, 1, ],
	[1, 1, 12, 12, 12, 12, 12, 1, 1, ],
	[1, 1, 12, 12, 12, 12, 12, 1, 1, ],
	[1, 1, 12, 12, 12, 12, 12, 1, 1, ],
	[1, 1, 12, 12, 12, 12, 12, 1, 1, ],
	[1, 1, 1, 1, 1, 1, 1, 1, 1, ],
	[1, 1, 1, 1, 1, 1, 1, 1, 1, ],
]
