Connections;up:ROUTE 103 (0.18);down:ROUTE 101 (0.16);left:ROUTE 102 (0.17);
Exits;OLDALE TOWN (2.0);OLDALE TOWN (2.1);OLDALE TOWN (2.2);OLDALE TOWN (2.4);
1 1 1 1 1 1 1 1 12 12 12 12 1 1 1 1 1 1 1 1 
1 1 1 1 1 1 1 1 12 12 12 12 1 1 1 1 1 1 1 1 
1 1 1 1 12 12 12 12 12 12 12 12 12 12 12 12 1 1 1 1 
1 1 1 1 12 12 12 12 12 12 12 12 12 12 12 12 1 1 1 1 
1 1 12 12 12 12 12 12 12 12 12 12 12 1 1 1 1 12 1 1 
1 1 12 12 1 1 1 1 12 12 12 12 12 1 1 1 1 12 1 1 
1 1 12 12 1 1 1 1 12 12 12 12 12 1 1 1 1 12 1 1 
1 1 12 12 1 1 1 1 12 12 12 12 12 12 12 12 12 12 1 1 
1 1 12 12 12 12 12 12 12 12 12 12 12 12 12 12 12 12 12 12 
1 1 12 12 12 12 12 12 12 12 12 1 12 12 12 12 12 12 12 12 
12 12 12 12 12 12 12 12 12 12 12 12 12 12 12 12 12 12 12 12 
12 12 12 12 12 12 12 12 12 12 12 12 12 12 12 12 12 12 12 12 
1 1 12 12 12 12 12 12 12 12 12 12 12 12 12 12 12 12 1 1 
1 1 12 12 12 12 12 12 12 12 12 12 12 12 12 12 12 12 1 1 
1 1 12 12 12 1 1 1 1 12 12 12 12 12 1 1 1 1 1 1 
1 1 12 12 12 1 1 1 1 12 12 12 12 12 1 1 1 1 1 1 
1 1 1 1 12 1 1 1 1 12 12 12 12 12 1 1 1 1 1 1 
1 1 1 1 12 12 12 12 12 12 12 12 12 12 12 12 12 12 1 1 
1 1 1 1 12 12 12 12 12 12 12 12 12 12 12 12 1 1 1 1 
1 1 1 1 12 12 12 12 12 12 12 12 12 12 12 12 1 1 1 1 
