connections=[
		],
events={
	{
		exits:[PACIFIDLOG TOWN (0.15),PACIFIDLOG TOWN (0.15),		]},
	{
		NPCs:[
			{is_trainer:0,b1:18,b2:0,sprite:10},
			{is_trainer:0,b1:10,b2:0,sprite:33},
		]},
	{
		signs:[
		]},
	{
		triggers:[
		]},

},
[
	[1, 1, 1, 1, 1, 1, 1, 1, 1, 1, ],
	[1, 1, 1, 1, 1, 1, 1, 1, 1, 1, ],
	[12, 12, 12, 12, 12, 13, 12, 12, 12, 12, ],
	[12, 12, 12, 12, 12, 12, 12, 12, 12, 12, ],
	[12, 12, 12, 12, 1, 1, 12, 12, 12, 12, ],
	[13, 12, 12, 12, 1, 1, 12, 12, 12, 12, ],
	[12, 12, 12, 12, 12, 12, 12, 12, 12, 12, ],
	[13, 12, 12, 12, 12, 12, 12, 12, 12, 12, ],
	[13, 12, 12, 12, 0, 0, 12, 12, 12, 13, ],
]
