Connections;
Exits;PACIFIDLOG TOWN (0.15);PACIFIDLOG TOWN (0.15);
1 1 1 1 1 1 1 1 1 1 
1 1 1 1 1 1 1 1 1 1 
12 12 12 12 12 13 12 12 12 12 
12 12 12 12 12 12 12 12 12 12 
12 12 12 12 1 1 12 12 12 12 
13 12 12 12 1 1 12 12 12 12 
12 12 12 12 12 12 12 12 12 12 
13 12 12 12 12 12 12 12 12 12 
13 12 12 12 0 0 12 12 12 13 
