Connections;left:ROUTE 132 (0.47);right:ROUTE 131 (0.46);
Exits;PACIFIDLOG TOWN (7.0);PACIFIDLOG TOWN (7.2);PACIFIDLOG TOWN (7.3);PACIFIDLOG TOWN (7.4);PACIFIDLOG TOWN (7.5);PACIFIDLOG TOWN (7.6);
1 1 1 1 1 1 1 1 1 1 1 1 1 1 1 1 1 1 1 1 
1 1 1 1 1 1 1 1 1 1 1 1 1 1 1 1 1 1 1 1 
1 1 1 1 1 1 1 1 1 1 1 1 1 1 1 1 1 1 1 1 
1 1 1 1 1 1 1 1 1 1 1 1 1 1 1 1 1 1 1 1 
1 1 1 1 1 1 1 1 1 1 1 1 1 1 1 1 1 1 1 1 
1 1 1 1 1 1 1 1 1 1 1 1 1 1 1 1 1 1 1 1 
1 1 1 1 1 1 1 1 1 1 1 1 1 1 1 1 1 1 1 1 
1 1 1 1 1 1 1 1 1 1 1 1 1 1 1 1 1 1 1 1 
4 4 4 4 4 1 1 1 1 1 1 1 1 1 1 4 4 4 4 4 
4 4 4 4 4 4 4 4 4 4 4 4 4 4 4 4 4 4 5 5 
4 4 4 4 4 4 4 4 4 4 4 4 4 4 4 4 4 4 5 5 
12 1 1 1 12 4 4 4 4 4 4 4 4 4 4 4 4 4 4 4 
12 1 1 1 12 4 4 4 4 4 4 4 4 4 12 1 1 1 12 4 
12 12 12 12 12 4 4 5 5 5 5 4 4 4 12 1 1 1 12 4 
12 12 12 12 12 4 12 1 1 1 1 12 4 4 12 12 12 12 12 4 
4 4 4 12 4 4 12 1 1 1 1 12 4 4 4 4 12 4 4 4 
4 4 4 12 4 4 12 1 12 12 12 12 4 4 4 4 12 4 4 4 
4 4 4 12 12 12 12 12 12 12 12 12 12 12 12 12 12 4 4 4 
4 4 4 4 4 4 4 4 12 4 4 4 4 4 4 4 4 4 4 4 
4 4 4 4 4 4 4 4 12 4 4 4 4 4 4 4 4 4 4 4 
4 4 4 4 4 4 4 4 12 4 4 4 4 4 4 12 1 1 1 12 
4 12 1 1 1 12 4 4 12 4 4 4 4 4 4 12 1 1 1 12 
4 12 1 1 1 12 4 4 12 4 4 4 4 4 4 12 12 12 12 12 
4 12 12 12 12 12 4 4 12 4 12 1 1 1 12 4 4 12 4 4 
4 4 4 12 4 4 4 4 12 4 12 1 1 1 12 4 4 12 4 4 
4 4 4 12 4 4 4 4 12 4 12 12 12 12 12 4 4 12 4 4 
4 4 4 12 12 12 12 12 12 4 4 4 12 4 4 4 4 12 4 4 
4 4 4 4 4 4 4 4 12 12 12 12 12 12 12 12 12 12 4 4 
4 4 4 4 4 4 4 4 12 4 4 4 4 4 4 4 4 4 4 4 
5 5 4 4 4 4 4 4 4 4 4 4 4 4 4 4 4 4 4 4 
5 5 4 4 4 4 4 4 4 4 4 4 4 4 4 4 5 5 4 4 
4 4 1 1 1 1 1 1 1 1 1 1 1 1 1 1 5 5 4 4 
1 1 1 1 1 1 1 1 1 1 1 1 1 1 1 1 1 1 1 1 
1 1 1 1 1 1 1 1 1 1 1 1 1 1 1 1 1 1 1 1 
1 1 1 1 1 1 1 1 1 1 1 1 1 1 1 1 1 1 1 1 
1 1 1 1 1 1 1 1 1 1 1 1 1 1 1 1 1 1 1 1 
1 1 1 1 1 1 1 1 1 1 1 1 1 1 1 1 1 1 1 1 
1 1 1 1 1 1 1 1 1 1 1 1 1 1 1 1 1 1 1 1 
1 1 1 1 1 1 1 1 1 1 1 1 1 1 1 1 1 1 1 1 
1 1 1 1 1 1 1 1 1 1 1 1 1 1 1 1 1 1 1 1 
