connections=[
			{'left':'ROUTE 104 (0.19)'},
			{'right':'ROUTE 102 (0.17)'},
		],
events={
	
		'exits':[{'name':'PETALBURG CITY (8.2)','x':10,'y':19},{'name':'PETALBURG CITY (8.0)','x':7,'y':5},{'name':'PETALBURG CITY (8.1)','x':15,'y':8},{'name':'PETALBURG CITY (8.4)','x':20,'y':16},{'name':'PETALBURG CITY (8.3)','x':20,'y':24},{'name':'PETALBURG CITY (8.6)','x':25,'y':12},		],
	
		'NPCs':[
			{'is_trainer':0,'b1':2,'b2':0,'sprite':'26','x':16,'y':18},
			{'is_trainer':0,'b1':7,'b2':0,'sprite':'135','x':15,'y':10},
			{'is_trainer':0,'b1':8,'b2':0,'sprite':'7','x':8,'y':22},
			{'is_trainer':0,'b1':3,'b2':0,'sprite':'48','x':20,'y':10},
			{'is_trainer':0,'b1':7,'b2':0,'sprite':'25','x':15,'y':10},
			{'is_trainer':0,'b1':1,'b2':0,'sprite':'59','x':19,'y':2},
			{'is_trainer':0,'b1':1,'b2':0,'sprite':'59','x':3,'y':28},
			{'is_trainer':0,'b1':1,'b2':0,'sprite':'9','x':12,'y':15},
			{'is_trainer':0,'b1':1,'b2':0,'sprite':'219','x':13,'y':12},
		],
	
		'signs':[
			{'x':17,'y':10},
			{'x':26,'y':12},
			{'x':21,'y':16},
			{'x':17,'y':16},
			{'x':22,'y':16},
			{'x':27,'y':12},
			{'x':8,'y':9},
			{'x':11,'y':29},
		],
	
		'triggers':[
			{'x':8,'y':10,'flag':16471,'scriptPointer':1950874},
			{'x':8,'y':11,'flag':16471,'scriptPointer':1950886},
			{'x':8,'y':12,'flag':16471,'scriptPointer':1950898},
			{'x':8,'y':13,'flag':16471,'scriptPointer':1950910},
			{'x':4,'y':10,'flag':16585,'scriptPointer':1951377},
			{'x':4,'y':11,'flag':16585,'scriptPointer':1951399},
			{'x':4,'y':12,'flag':16585,'scriptPointer':1951421},
			{'x':4,'y':13,'flag':16585,'scriptPointer':1951443},
		],

},
partial_map=[
	[1, 1, 1, 1, 1, 1, 1, 1, 1, 1, 1, 1, 1, 1, 1, 1, 1, 1, 1, 1, 1, 1, 1, 1, 1, 1, 1, 1, 1, 1, ],
	[1, 1, 1, 1, 1, 1, 1, 1, 1, 1, 1, 1, 1, 1, 1, 1, 1, 1, 1, 1, 1, 1, 1, 1, 1, 1, 1, 1, 1, 1, ],
	[1, 1, 1, 1, 1, 1, 1, 1, 1, 1, 1, 1, 1, 1, 1, 1, 1, 1, 1, 12, 12, 12, 4, 4, 4, 4, 1, 1, 1, 1, ],
	[1, 1, 1, 1, 1, 1, 1, 1, 1, 1, 1, 13, 1, 1, 1, 1, 1, 1, 13, 4, 4, 4, 4, 4, 4, 4, 1, 1, 1, 1, ],
	[1, 1, 1, 1, 1, 1, 1, 1, 1, 1, 1, 1, 1, 1, 1, 1, 1, 1, 1, 4, 4, 4, 4, 4, 4, 4, 1, 1, 1, 1, ],
	[1, 1, 1, 1, 12, 1, 1, 1, 1, 1, 1, 1, 1, 1, 1, 1, 1, 1, 1, 4, 4, 4, 4, 4, 4, 4, 1, 1, 1, 1, ],
	[1, 1, 1, 1, 12, 12, 12, 12, 12, 12, 1, 1, 1, 1, 1, 1, 1, 1, 1, 4, 4, 4, 4, 4, 4, 4, 1, 1, 1, 1, ],
	[1, 1, 1, 1, 12, 12, 12, 12, 12, 12, 1, 1, 1, 1, 1, 1, 1, 1, 1, 4, 4, 4, 4, 4, 4, 4, 1, 1, 1, 1, ],
	[1, 1, 1, 1, 12, 12, 12, 12, 12, 12, 1, 1, 12, 12, 1, 1, 1, 12, 1, 4, 4, 4, 4, 4, 4, 4, 1, 1, 1, 1, ],
	[1, 1, 13, 13, 12, 12, 12, 12, 1, 1, 1, 1, 12, 12, 12, 12, 12, 12, 1, 12, 12, 12, 12, 12, 12, 12, 1, 1, 1, 1, ],
	[1, 1, 12, 12, 12, 12, 12, 12, 12, 12, 12, 12, 12, 12, 12, 12, 12, 1, 12, 12, 12, 12, 12, 12, 1, 1, 1, 1, 1, 1, ],
	[13, 13, 12, 12, 12, 12, 12, 12, 12, 12, 12, 12, 12, 12, 12, 12, 12, 12, 12, 12, 12, 12, 12, 12, 1, 1, 1, 1, 1, 1, ],
	[12, 12, 12, 12, 12, 12, 12, 12, 12, 12, 12, 12, 12, 12, 12, 12, 12, 12, 12, 12, 12, 12, 12, 12, 1, 1, 1, 1, 1, 1, ],
	[12, 12, 12, 12, 12, 12, 12, 12, 12, 12, 12, 12, 12, 12, 12, 12, 12, 12, 12, 12, 12, 12, 12, 12, 12, 12, 12, 12, 1, 1, ],
	[1, 1, 4, 4, 4, 4, 4, 1, 1, 12, 12, 12, 12, 12, 12, 12, 12, 12, 12, 1, 1, 1, 1, 12, 12, 12, 12, 12, 1, 1, ],
	[1, 1, 4, 4, 4, 4, 4, 1, 1, 12, 12, 12, 12, 12, 12, 12, 12, 12, 12, 1, 1, 1, 1, 12, 12, 12, 12, 12, 13, 1, ],
	[1, 1, 4, 4, 4, 4, 4, 1, 1, 12, 12, 12, 12, 12, 12, 12, 12, 1, 12, 1, 1, 1, 1, 12, 12, 12, 12, 12, 12, 12, ],
	[1, 1, 4, 4, 4, 4, 4, 1, 1, 1, 1, 1, 1, 12, 12, 12, 12, 12, 12, 12, 12, 12, 12, 12, 12, 12, 12, 12, 12, 12, ],
	[1, 1, 4, 4, 4, 4, 4, 1, 1, 1, 1, 1, 1, 12, 12, 12, 12, 12, 12, 12, 12, 12, 12, 12, 12, 12, 12, 12, 12, 12, ],
	[1, 1, 4, 4, 4, 4, 4, 13, 13, 1, 1, 1, 1, 12, 12, 12, 12, 12, 12, 12, 12, 12, 12, 12, 12, 12, 12, 12, 12, 12, ],
	[1, 1, 4, 4, 4, 4, 4, 12, 12, 12, 12, 12, 12, 12, 12, 12, 12, 12, 12, 12, 12, 12, 12, 12, 12, 12, 1, 1, 1, 1, ],
	[1, 1, 4, 4, 4, 4, 4, 12, 12, 12, 12, 12, 12, 12, 12, 12, 12, 12, 1, 1, 1, 1, 1, 1, 1, 1, 1, 1, 1, 1, ],
	[1, 1, 4, 4, 4, 4, 4, 12, 12, 12, 12, 12, 12, 12, 12, 12, 12, 12, 1, 1, 1, 1, 1, 1, 1, 1, 1, 1, 1, 1, ],
	[1, 1, 4, 4, 4, 4, 4, 4, 4, 4, 4, 4, 12, 12, 12, 12, 12, 12, 1, 1, 1, 1, 1, 1, 1, 1, 1, 1, 1, 1, ],
	[1, 1, 4, 4, 4, 4, 4, 4, 4, 4, 4, 4, 1, 1, 12, 12, 12, 12, 12, 1, 1, 1, 1, 12, 12, 1, 1, 1, 1, 1, ],
	[1, 1, 4, 4, 4, 4, 4, 4, 4, 4, 4, 4, 1, 1, 12, 12, 12, 12, 12, 12, 12, 12, 12, 12, 12, 1, 1, 1, 1, 1, ],
	[1, 1, 4, 4, 4, 4, 4, 4, 4, 4, 4, 4, 1, 1, 12, 12, 12, 12, 12, 12, 12, 12, 12, 12, 12, 1, 1, 1, 1, 1, ],
	[1, 1, 4, 4, 4, 4, 4, 4, 4, 4, 4, 4, 1, 1, 12, 12, 12, 12, 12, 12, 12, 12, 12, 12, 12, 12, 1, 1, 1, 1, ],
	[1, 1, 12, 12, 12, 1, 1, 1, 1, 1, 1, 12, 1, 1, 1, 1, 1, 1, 1, 1, 1, 1, 1, 1, 1, 1, 1, 1, 1, 1, ],
	[1, 1, 12, 12, 12, 1, 1, 1, 1, 1, 1, 12, 1, 1, 1, 1, 1, 1, 1, 1, 1, 1, 1, 1, 1, 1, 1, 1, 1, 1, ],
]
