Connections;left:ROUTE 104 (0.19);right:ROUTE 102 (0.17);
Exits;PETALBURG CITY (8.2);PETALBURG CITY (8.0);PETALBURG CITY (8.1);PETALBURG CITY (8.4);PETALBURG CITY (8.3);PETALBURG CITY (8.6);
1 1 1 1 1 1 1 1 1 1 1 1 1 1 1 1 1 1 1 1 1 1 1 1 1 1 1 1 1 1 
1 1 1 1 1 1 1 1 1 1 1 1 1 1 1 1 1 1 1 1 1 1 1 1 1 1 1 1 1 1 
1 1 1 1 1 1 1 1 1 1 1 1 1 1 1 1 1 1 1 12 12 12 4 4 4 4 1 1 1 1 
1 1 1 1 1 1 1 1 1 1 1 13 1 1 1 1 1 1 13 4 4 4 4 4 4 4 1 1 1 1 
1 1 1 1 1 1 1 1 1 1 1 1 1 1 1 1 1 1 1 4 4 4 4 4 4 4 1 1 1 1 
1 1 1 1 12 1 1 1 1 1 1 1 1 1 1 1 1 1 1 4 4 4 4 4 4 4 1 1 1 1 
1 1 1 1 12 12 12 12 12 12 1 1 1 1 1 1 1 1 1 4 4 4 4 4 4 4 1 1 1 1 
1 1 1 1 12 12 12 12 12 12 1 1 1 1 1 1 1 1 1 4 4 4 4 4 4 4 1 1 1 1 
1 1 1 1 12 12 12 12 12 12 1 1 12 12 1 1 1 12 1 4 4 4 4 4 4 4 1 1 1 1 
1 1 13 13 12 12 12 12 1 1 1 1 12 12 12 12 12 12 1 12 12 12 12 12 12 12 1 1 1 1 
1 1 12 12 12 12 12 12 12 12 12 12 12 12 12 12 12 1 12 12 12 12 12 12 1 1 1 1 1 1 
13 13 12 12 12 12 12 12 12 12 12 12 12 12 12 12 12 12 12 12 12 12 12 12 1 1 1 1 1 1 
12 12 12 12 12 12 12 12 12 12 12 12 12 12 12 12 12 12 12 12 12 12 12 12 1 1 1 1 1 1 
12 12 12 12 12 12 12 12 12 12 12 12 12 12 12 12 12 12 12 12 12 12 12 12 12 12 12 12 1 1 
1 1 4 4 4 4 4 1 1 12 12 12 12 12 12 12 12 12 12 1 1 1 1 12 12 12 12 12 1 1 
1 1 4 4 4 4 4 1 1 12 12 12 12 12 12 12 12 12 12 1 1 1 1 12 12 12 12 12 13 1 
1 1 4 4 4 4 4 1 1 12 12 12 12 12 12 12 12 1 12 1 1 1 1 12 12 12 12 12 12 12 
1 1 4 4 4 4 4 1 1 1 1 1 1 12 12 12 12 12 12 12 12 12 12 12 12 12 12 12 12 12 
1 1 4 4 4 4 4 1 1 1 1 1 1 12 12 12 12 12 12 12 12 12 12 12 12 12 12 12 12 12 
1 1 4 4 4 4 4 13 13 1 1 1 1 12 12 12 12 12 12 12 12 12 12 12 12 12 12 12 12 12 
1 1 4 4 4 4 4 12 12 12 12 12 12 12 12 12 12 12 12 12 12 12 12 12 12 12 1 1 1 1 
1 1 4 4 4 4 4 12 12 12 12 12 12 12 12 12 12 12 1 1 1 1 1 1 1 1 1 1 1 1 
1 1 4 4 4 4 4 12 12 12 12 12 12 12 12 12 12 12 1 1 1 1 1 1 1 1 1 1 1 1 
1 1 4 4 4 4 4 4 4 4 4 4 12 12 12 12 12 12 1 1 1 1 1 1 1 1 1 1 1 1 
1 1 4 4 4 4 4 4 4 4 4 4 1 1 12 12 12 12 12 1 1 1 1 12 12 1 1 1 1 1 
1 1 4 4 4 4 4 4 4 4 4 4 1 1 12 12 12 12 12 12 12 12 12 12 12 1 1 1 1 1 
1 1 4 4 4 4 4 4 4 4 4 4 1 1 12 12 12 12 12 12 12 12 12 12 12 1 1 1 1 1 
1 1 4 4 4 4 4 4 4 4 4 4 1 1 12 12 12 12 12 12 12 12 12 12 12 12 1 1 1 1 
1 1 12 12 12 1 1 1 1 1 1 12 1 1 1 1 1 1 1 1 1 1 1 1 1 1 1 1 1 1 
1 1 12 12 12 1 1 1 1 1 1 12 1 1 1 1 1 1 1 1 1 1 1 1 1 1 1 1 1 1 
