Connections;left:DEWFORD TOWN (0.11);right:ROUTE 108 (0.23);
Exits;
12 13 13 13 1 13 13 13 13 5 4 4 4 4 4 4 4 4 4 4 4 4 4 4 4 4 4 4 4 4 4 4 4 4 4 4 4 4 4 4 4 4 4 4 4 4 4 4 4 1 1 4 4 4 4 4 4 4 1 1 
13 1 1 1 12 1 1 13 1 5 4 4 4 4 4 4 4 4 4 4 4 4 4 4 4 4 4 4 4 4 4 4 4 4 4 4 4 4 4 4 1 1 4 4 4 4 4 1 1 1 1 1 1 4 4 4 1 1 1 1 
13 12 1 1 1 1 12 1 12 5 4 4 4 4 4 4 4 4 4 4 4 4 4 4 4 4 4 4 1 1 4 4 1 1 4 4 4 4 1 1 1 1 4 4 4 1 1 1 1 4 4 1 1 4 1 1 1 1 4 4 
13 1 1 12 1 1 1 5 5 5 4 4 4 4 4 4 1 1 4 4 5 1 5 4 1 1 1 1 1 1 1 1 1 1 1 1 1 1 1 1 4 4 5 1 5 1 1 4 4 4 4 4 1 1 1 1 1 1 4 4 
1 13 1 1 12 12 1 1 1 1 1 1 4 4 1 1 1 1 1 1 1 0 1 4 1 1 1 1 4 4 1 1 4 4 1 1 1 1 4 4 4 5 1 0 1 4 4 4 4 4 4 4 1 1 4 4 1 1 4 4 
12 1 13 1 1 1 1 1 1 1 1 1 1 1 1 1 4 4 1 1 1 1 1 1 1 4 4 4 4 4 4 4 4 4 4 4 4 4 4 4 4 1 1 1 1 4 4 4 4 4 4 4 4 4 4 4 4 4 4 4 
12 12 1 12 1 5 5 5 4 4 4 4 1 1 4 4 4 4 4 4 4 4 4 1 1 4 4 4 4 4 4 4 4 4 4 4 4 4 4 4 4 4 4 4 4 4 4 4 4 4 4 4 4 4 4 4 4 4 4 4 
5 5 5 5 5 5 4 4 4 4 4 4 4 4 4 4 4 4 4 4 4 4 4 4 4 4 4 4 4 4 4 4 4 4 4 4 4 4 4 4 4 4 4 4 4 4 4 4 4 4 4 4 4 4 4 4 4 4 4 4 
4 4 4 4 4 4 4 4 4 4 4 4 4 4 4 4 4 4 4 4 4 4 4 4 4 4 4 4 4 4 4 4 4 4 4 4 4 4 4 4 4 4 4 4 4 4 4 4 4 4 4 4 4 4 4 4 4 4 4 4 
4 4 4 4 4 4 4 4 4 4 4 4 4 4 4 4 4 4 4 4 4 4 4 4 4 4 4 4 4 4 4 4 4 4 4 4 4 4 4 4 4 4 4 4 4 4 4 4 4 4 4 4 4 4 4 4 4 4 4 4 
12 12 12 12 12 4 4 4 4 4 4 4 4 4 4 4 4 4 4 4 4 4 4 4 4 4 4 4 4 4 4 4 4 4 4 4 4 4 4 4 4 4 4 4 4 4 4 4 4 4 4 4 4 4 4 4 4 4 4 4 
12 12 12 12 12 4 4 4 4 4 4 4 4 4 4 4 4 4 4 4 4 4 4 4 4 4 4 4 4 4 4 4 4 4 4 4 4 4 4 4 4 4 4 4 4 4 4 4 4 4 4 4 4 4 4 4 4 4 4 4 
12 12 12 12 12 12 4 4 4 4 4 4 4 4 4 4 4 4 4 4 4 4 4 4 4 4 4 4 4 4 4 4 4 4 4 4 1 1 4 4 4 4 4 4 4 4 4 4 4 4 4 1 1 4 4 4 4 4 4 4 
12 12 12 12 12 12 12 4 4 4 4 4 4 4 4 1 1 4 4 4 4 4 4 4 4 4 4 4 4 4 4 4 1 1 4 4 1 1 4 4 4 4 4 4 4 1 1 5 1 1 5 1 1 4 4 4 4 4 4 4 
12 1 1 1 12 1 12 1 1 5 1 1 5 4 4 1 1 1 1 4 4 4 4 4 4 4 4 1 1 5 1 5 1 1 1 1 4 1 1 4 4 4 4 1 1 1 1 1 0 0 1 4 1 1 1 1 4 4 4 4 
1 1 1 12 1 12 1 1 1 1 1 1 1 1 1 4 4 1 1 1 1 1 1 4 4 4 4 1 1 1 0 1 5 4 1 1 4 1 1 4 4 4 4 1 1 4 4 1 1 1 1 4 1 1 1 1 1 1 4 4 
1 1 12 1 1 1 1 4 4 4 4 1 5 1 1 4 4 4 4 1 1 1 1 1 1 4 4 4 4 1 1 0 1 4 4 4 4 4 1 1 4 4 1 1 4 4 4 4 4 4 4 1 1 4 4 4 1 1 1 1 
12 1 1 1 1 1 12 4 4 4 4 4 4 4 4 4 4 4 4 4 4 4 4 1 1 1 1 1 1 4 1 1 1 4 4 4 4 4 1 1 1 1 1 1 4 4 4 4 4 4 4 1 1 4 4 4 4 4 1 1 
1 1 12 1 1 12 1 12 4 4 4 4 4 4 4 4 4 4 4 4 4 4 4 4 4 1 1 1 1 4 4 1 5 4 4 4 4 4 4 4 1 1 4 4 4 4 4 4 4 4 4 4 4 4 4 4 4 4 4 4 
1 1 1 1 1 1 1 0 4 4 4 4 4 4 4 4 4 4 4 4 4 4 4 4 4 4 4 4 4 4 4 4 4 4 4 4 4 4 4 4 4 4 4 4 4 4 4 4 4 4 4 4 4 4 4 4 4 4 4 4 
