Connections;
Exits;ROUTE 114 (0.29);ROUTE 114 (0.29);
1 1 1 1 1 1 1 1 1 1 1 
1 1 1 1 1 1 1 1 1 1 1 
1 12 1 12 12 12 12 12 12 1 12 
1 1 1 12 1 12 1 1 12 1 12 
1 12 12 12 1 12 1 1 12 1 1 
1 1 1 12 1 12 1 1 12 12 12 
1 1 1 12 12 12 12 12 12 1 1 
1 1 1 12 12 0 0 1 1 1 1 
