Connections;
Exits;ROUTE 114 (20.0);ROUTE 114 (20.0);DESERT UNDERPASS (24.98);
12 0 1 1 1 1 1 1 1 1 12 12 12 
0 1 1 1 1 1 0 1 1 1 12 0 0 
0 1 1 1 1 1 0 1 1 1 1 0 0 
12 1 1 1 1 12 12 1 1 1 1 0 0 
0 1 1 1 12 12 12 1 1 1 1 0 0 
0 1 1 1 13 12 12 12 1 1 1 0 0 
0 1 1 1 12 12 12 13 1 1 1 0 0 
0 1 1 1 12 12 12 12 1 1 1 0 0 
0 1 1 12 1 12 12 12 1 1 1 0 0 
0 1 12 1 1 12 12 13 1 1 1 0 0 
0 12 1 1 1 12 12 12 1 1 1 0 0 
0 12 1 1 1 12 12 13 0 1 1 0 0 
0 12 1 1 1 13 12 1 13 1 1 1 12 
0 12 1 1 1 12 12 1 12 1 1 1 12 
0 12 1 1 1 12 12 1 12 13 1 1 12 
0 12 1 1 1 12 12 1 12 13 1 1 12 
0 1 1 1 12 1 12 1 12 13 1 1 12 
0 1 12 1 12 1 12 1 13 13 1 1 12 
0 1 13 1 12 1 12 1 1 12 1 1 1 
0 1 12 1 13 1 12 12 1 12 1 12 1 
0 1 12 1 12 1 12 12 1 12 1 13 1 
0 1 12 1 12 1 12 13 1 12 1 1 1 
1 1 12 1 13 1 12 12 1 13 13 1 1 
1 13 12 1 1 1 12 12 1 1 12 1 1 
1 13 12 1 1 12 12 12 12 1 12 1 1 
1 13 12 1 1 12 12 12 12 1 12 1 1 
