Connections;
Exits;ROUTE 119 (32.0);
1 1 1 1 1 1 1 1 1 1 1 1 1 1 1 1 13 13 13 1 
1 1 1 1 1 1 1 1 1 1 1 1 1 1 1 1 13 0 13 1 
12 12 12 12 1 1 1 1 1 1 1 1 1 1 1 12 12 12 12 12 
12 1 12 12 1 12 12 12 1 1 12 12 12 1 1 12 12 12 12 12 
12 1 12 12 1 12 12 12 1 1 12 12 12 1 1 12 12 12 12 12 
12 1 12 12 1 12 12 12 1 1 12 12 12 1 1 12 12 12 12 12 
12 12 12 12 12 12 12 12 12 12 12 12 12 12 12 12 12 12 12 12 
12 12 12 12 1 12 12 12 1 1 12 12 12 1 1 12 12 12 12 12 
12 1 12 12 1 12 12 12 1 1 12 12 12 1 1 12 12 12 12 12 
12 1 12 12 1 12 12 12 1 1 12 12 12 1 1 12 12 12 12 12 
12 1 12 12 1 12 12 12 12 12 12 12 12 12 12 12 12 12 12 12 
