connections=[
		],
events={
	{
		exits:[ROUTE 110 (29.0),ROUTE 110 (29.0),ROUTE 110 (29.1),		]},
	{
		NPCs:[
			{is_trainer:1,b1:8,b2:0,sprite:31},
			{is_trainer:1,b1:10,b2:0,sprite:32},
			{is_trainer:1,b1:8,b2:0,sprite:55},
			{is_trainer:0,b1:1,b2:0,sprite:59},
			{is_trainer:0,b1:1,b2:0,sprite:59},
			{is_trainer:0,b1:1,b2:0,sprite:86},
			{is_trainer:0,b1:1,b2:0,sprite:86},
		]},
	{
		signs:[
			{x:0,y:14},
		]},
	{
		triggers:[
			{x:4,y:14,flag:16385,scriptPointer:2540749},
			{x:3,y:11,flag:16386,scriptPointer:2540761},
			{x:12,y:5,flag:16387,scriptPointer:2540773},
			{x:8,y:2,flag:16388,scriptPointer:2540785},
		]},

},
[
	[1, 1, 1, 1, 1, 1, 1, 1, 1, 1, 1, 1, 1, 1, 1, ],
	[1, 1, 1, 1, 1, 1, 1, 1, 1, 1, 1, 1, 1, 13, 1, ],
	[1, 12, 12, 1, 12, 12, 1, 12, 12, 1, 12, 12, 1, 12, 12, ],
	[1, 12, 12, 1, 12, 12, 1, 12, 12, 1, 12, 12, 1, 12, 12, ],
	[1, 1, 1, 1, 12, 12, 1, 12, 12, 1, 12, 12, 1, 1, 1, ],
	[12, 12, 12, 12, 12, 12, 12, 12, 12, 1, 12, 12, 12, 12, 12, ],
	[1, 12, 12, 1, 12, 12, 1, 12, 12, 1, 12, 12, 1, 12, 12, ],
	[1, 12, 12, 1, 1, 1, 1, 12, 12, 1, 1, 1, 1, 12, 12, ],
	[12, 12, 12, 12, 12, 12, 12, 12, 12, 1, 12, 12, 12, 12, 12, ],
	[1, 12, 12, 1, 1, 1, 1, 12, 12, 1, 12, 12, 1, 12, 12, ],
	[1, 12, 12, 1, 1, 1, 1, 1, 1, 1, 12, 12, 1, 12, 12, ],
	[12, 12, 12, 12, 12, 12, 12, 12, 12, 12, 12, 12, 12, 12, 12, ],
	[1, 12, 12, 1, 12, 12, 1, 12, 12, 1, 12, 12, 1, 12, 12, ],
	[1, 1, 1, 1, 1, 1, 1, 12, 12, 1, 1, 1, 1, 12, 12, ],
	[1, 12, 12, 12, 12, 12, 12, 12, 12, 12, 12, 12, 1, 12, 12, ],
	[1, 1, 1, 1, 12, 12, 1, 1, 1, 1, 12, 12, 1, 12, 12, ],
	[1, 1, 1, 1, 12, 12, 1, 1, 1, 1, 12, 12, 1, 12, 12, ],
	[12, 12, 12, 1, 12, 12, 1, 12, 12, 12, 12, 12, 12, 12, 12, ],
	[1, 12, 12, 1, 12, 12, 1, 12, 12, 1, 12, 12, 1, 12, 12, ],
	[1, 12, 12, 1, 1, 1, 1, 12, 12, 1, 1, 1, 1, 12, 12, ],
	[12, 12, 12, 12, 12, 12, 12, 12, 12, 12, 12, 12, 12, 12, 12, ],
	[12, 12, 12, 12, 12, 12, 12, 12, 12, 12, 12, 12, 12, 12, 12, ],
]
