Connections;left:SLATEPORT CITY (0.1);right:ROUTE 133 (0.48);
Exits;
4 4 4 4 4 4 4 4 4 4 4 4 4 4 4 4 4 4 4 4 4 4 4 1 1 4 4 4 4 1 1 4 4 4 4 4 4 1 1 1 1 4 4 4 4 4 4 4 1 1 1 1 4 4 1 1 4 4 4 1 1 1 1 1 1 1 1 4 4 1 1 4 4 4 4 4 4 4 1 1 
4 4 4 4 4 4 4 4 4 4 1 1 4 4 1 1 1 1 4 1 1 1 4 1 1 4 4 1 1 1 1 1 1 4 4 1 1 1 1 1 1 1 1 4 4 1 1 4 1 1 1 1 1 1 1 1 4 1 1 1 1 1 1 1 1 1 1 1 1 1 1 1 1 4 4 1 1 4 1 1 
4 4 4 4 4 4 1 1 4 4 1 1 1 1 1 1 1 1 4 5 4 1 1 1 4 1 1 1 1 4 4 1 1 1 1 1 1 4 4 4 4 1 1 1 1 1 1 1 1 4 4 4 1 1 4 1 1 1 1 4 12 12 12 12 12 12 4 1 1 4 4 1 1 1 1 1 1 1 1 4 
4 1 1 4 4 4 1 1 1 1 1 4 1 1 4 4 4 1 1 5 5 5 1 1 4 1 1 4 4 4 4 4 4 1 1 4 4 4 4 4 4 4 4 1 1 4 4 1 1 4 4 4 4 4 4 1 1 4 4 4 12 1 1 1 1 12 12 12 12 12 12 12 4 1 1 4 4 1 1 4 
4 1 1 4 1 1 1 4 1 4 5 4 4 4 4 4 4 1 1 4 4 4 4 4 4 4 4 4 12 12 4 4 4 4 4 4 4 4 4 4 4 4 4 4 4 4 4 4 4 4 4 4 4 4 4 4 4 4 4 4 4 1 1 1 1 1 1 1 1 1 1 12 4 4 4 4 4 4 4 4 
1 1 4 1 1 4 1 4 5 5 5 4 4 4 4 4 4 4 4 4 4 4 4 4 4 4 4 4 12 12 12 4 4 4 4 4 4 4 4 4 4 4 4 4 4 4 4 4 4 4 4 4 4 4 4 4 4 4 4 4 4 4 4 4 12 1 1 1 1 1 1 4 4 4 4 4 4 4 4 4 
1 1 4 1 4 5 5 4 4 4 4 4 4 4 4 4 4 4 4 4 4 4 4 4 4 4 4 4 12 12 12 12 4 4 4 4 4 4 4 4 4 4 4 4 4 4 4 4 4 4 4 4 4 4 4 4 4 4 4 4 4 4 4 4 4 4 4 4 4 4 4 4 4 4 4 4 4 4 4 4 
4 4 4 5 5 5 4 4 4 4 4 4 4 4 4 4 4 4 4 4 4 4 4 12 12 4 4 4 12 12 12 12 12 4 4 4 4 4 4 4 4 4 4 4 4 4 4 4 4 4 4 4 4 4 4 4 4 4 4 4 4 4 4 4 4 4 4 4 4 4 4 4 4 4 4 4 4 4 4 4 
4 4 4 4 4 4 4 4 4 4 4 4 4 4 4 4 4 4 4 4 4 4 4 12 12 4 4 4 12 12 12 12 12 4 4 4 4 4 4 4 4 4 4 4 4 4 4 4 4 4 4 4 4 4 4 4 4 4 4 4 4 4 4 4 4 4 4 12 12 12 12 4 4 4 4 4 4 4 4 4 
4 4 4 4 4 4 4 4 4 4 4 4 4 4 4 4 4 4 4 4 4 4 4 12 12 12 4 4 1 1 1 12 12 4 4 1 1 4 4 4 4 4 4 4 4 4 4 4 4 4 4 4 4 4 4 4 4 4 4 4 4 4 4 4 12 12 12 1 1 1 1 4 4 4 4 4 4 4 4 4 
4 4 4 4 4 4 4 4 4 4 4 4 4 4 4 4 4 4 4 4 4 4 4 12 12 12 4 4 1 1 1 1 4 4 4 1 1 4 1 1 4 4 4 4 4 4 4 4 4 4 4 4 4 4 4 4 4 4 4 4 4 4 4 12 1 1 1 1 1 1 1 4 4 4 4 4 4 4 4 4 
4 4 4 4 4 4 4 4 4 4 4 4 4 4 4 4 4 4 4 4 4 4 12 12 12 12 4 4 1 1 1 1 4 4 4 4 4 4 1 1 4 4 4 4 4 4 4 4 4 4 4 4 4 4 4 4 4 4 4 4 4 12 12 1 1 1 1 1 1 4 4 4 4 4 4 4 4 4 4 4 
4 4 4 4 4 4 4 4 4 4 4 4 4 4 4 4 4 4 4 4 4 12 12 12 12 12 4 4 4 1 1 12 12 12 12 12 12 12 12 12 4 4 4 4 4 4 4 4 4 4 4 4 4 4 4 4 4 4 4 4 12 1 1 0 1 1 12 12 12 4 4 4 4 4 4 4 4 4 4 4 
4 4 4 4 4 4 4 4 4 4 4 4 4 4 4 4 4 4 4 4 4 12 12 1 1 12 4 4 4 1 1 12 12 12 12 12 12 12 12 12 12 12 12 4 4 4 4 4 4 4 4 4 4 4 4 4 4 4 4 4 1 0 1 1 1 12 12 12 4 4 4 4 4 4 4 4 4 4 4 4 
4 4 4 4 4 4 4 4 4 4 4 4 4 4 4 4 4 4 4 4 12 12 12 1 1 12 4 4 4 4 12 12 1 1 1 1 1 1 12 12 12 12 12 12 12 12 12 12 12 12 12 12 12 12 12 12 12 12 12 12 1 1 1 12 12 12 12 12 4 4 4 4 4 4 4 4 4 4 4 4 
1 1 4 4 4 4 4 4 4 4 4 4 4 4 4 4 4 4 4 4 12 12 12 12 12 12 4 4 4 4 4 12 1 1 1 1 1 1 12 1 1 12 12 12 12 12 12 12 12 12 12 12 12 12 12 12 12 1 1 12 1 1 12 12 12 12 12 4 4 4 4 4 4 4 4 4 4 4 4 4 
1 1 1 1 4 4 4 4 4 4 4 4 4 4 4 4 4 4 4 4 12 12 1 1 12 12 4 4 4 4 4 4 4 4 4 4 4 4 4 1 1 1 1 12 12 12 12 12 12 12 12 12 12 12 12 12 12 1 1 1 1 12 12 12 12 12 4 4 4 4 4 4 4 4 4 4 4 4 4 4 
4 4 1 1 1 1 1 1 4 4 4 4 4 4 4 4 4 4 4 4 4 4 1 1 12 12 4 4 4 4 4 4 4 4 4 4 4 4 4 4 4 1 1 12 12 12 12 12 12 12 12 12 12 12 12 12 12 12 12 1 1 12 12 12 4 4 4 4 4 4 4 4 4 4 4 4 4 4 4 4 
4 4 4 4 1 4 4 1 1 5 4 4 4 4 4 4 4 4 4 4 4 4 4 4 4 4 4 4 4 4 4 4 4 4 4 4 4 4 4 4 4 4 4 4 4 4 4 4 4 4 4 4 4 4 4 4 4 4 4 4 4 4 4 4 4 4 4 4 4 4 4 4 4 4 4 4 4 4 4 4 
4 4 4 4 5 5 4 4 4 5 4 4 4 4 4 4 4 4 4 4 4 4 4 4 4 4 4 4 4 4 4 4 4 4 4 4 4 4 4 4 4 4 4 4 4 4 4 4 4 4 4 4 4 4 4 4 4 4 4 4 4 4 4 4 4 4 4 4 4 4 4 4 4 4 4 4 4 4 4 4 
4 4 4 4 4 5 5 5 5 1 4 4 4 4 4 4 4 4 4 4 4 4 4 4 4 4 4 4 4 4 4 4 4 4 4 4 4 4 4 4 4 4 4 4 4 4 4 4 4 4 4 4 4 4 4 4 4 4 4 4 4 4 4 4 4 4 4 4 4 4 4 4 4 4 4 4 4 4 4 4 
4 4 4 4 4 4 4 4 4 1 1 4 4 4 4 4 4 4 4 4 4 4 4 4 4 4 4 4 4 4 4 4 4 4 4 4 4 4 4 4 4 4 4 4 4 4 4 4 4 4 4 4 4 4 4 4 4 4 4 4 4 4 4 4 4 4 4 4 4 4 4 4 4 4 4 4 4 4 4 4 
4 4 4 4 4 4 4 4 4 1 1 4 4 4 4 4 4 4 4 4 4 4 4 4 12 12 12 12 12 4 4 4 4 4 1 1 4 4 4 4 4 12 12 12 4 4 4 1 1 1 1 4 4 4 4 4 4 4 1 1 1 1 4 4 4 4 4 4 4 4 4 4 4 4 4 4 4 4 4 4 
4 4 4 4 4 4 4 4 4 1 1 5 4 4 4 4 4 4 4 4 4 4 4 12 12 12 12 12 12 12 4 4 4 4 1 1 1 1 4 4 4 12 12 12 4 1 1 1 1 1 1 4 4 4 4 1 1 4 1 1 1 1 4 4 4 4 4 4 4 4 4 4 4 4 4 4 4 4 4 4 
4 4 4 4 4 4 4 4 4 1 4 5 4 4 4 4 4 4 4 4 4 4 4 12 12 12 12 12 12 12 12 4 4 4 4 4 1 1 1 1 4 4 4 4 4 1 1 4 4 4 4 4 4 1 1 1 1 4 4 4 4 4 4 4 4 4 4 4 4 4 4 4 4 4 4 4 4 4 4 4 
4 4 4 4 4 4 4 4 4 5 5 1 4 4 4 4 4 4 4 4 4 4 12 12 12 12 12 12 12 12 12 4 4 4 4 1 1 4 1 1 1 1 4 4 4 1 1 4 4 4 4 4 4 1 1 4 1 1 4 4 1 1 4 4 4 4 4 4 4 4 4 4 4 4 4 4 4 4 4 4 
4 4 4 4 4 4 4 4 4 4 1 1 1 1 5 4 4 4 4 4 4 4 12 12 12 1 1 12 12 12 12 4 4 4 4 1 1 4 4 4 1 1 4 4 4 1 1 4 1 1 4 4 4 4 4 4 1 1 4 4 1 1 4 4 4 4 4 4 4 4 4 4 4 4 4 4 4 12 12 12 
4 4 4 4 4 4 4 4 4 4 1 1 1 4 1 5 4 4 4 4 4 4 12 12 12 1 1 12 12 12 4 4 4 4 4 4 4 4 4 4 4 1 1 4 1 1 4 4 1 1 4 4 4 4 4 4 4 4 4 4 4 4 4 4 4 4 4 4 4 4 4 4 4 4 4 4 12 12 12 12 
4 4 4 4 4 4 4 4 4 4 4 4 5 5 4 5 4 4 4 4 4 4 12 12 12 12 12 12 12 4 4 4 4 4 4 1 1 4 4 4 4 1 1 4 1 1 4 4 4 1 1 4 4 1 1 1 1 4 4 4 4 4 4 4 4 1 1 4 4 4 4 4 4 4 4 12 12 12 12 12 
4 4 4 4 4 4 4 4 4 4 4 4 4 5 5 1 4 4 4 4 4 4 12 12 12 12 12 12 12 4 4 4 4 4 4 1 1 1 1 4 4 1 1 4 4 4 4 1 1 1 1 4 4 1 1 1 1 4 4 4 4 4 4 4 4 1 1 4 4 4 4 4 4 4 4 12 12 12 12 12 
4 4 4 4 4 4 4 4 4 4 4 4 4 1 1 4 4 4 4 4 4 4 4 12 12 12 12 12 4 4 4 4 4 4 4 4 4 1 1 4 4 1 1 1 1 1 1 1 1 4 4 4 1 1 4 4 4 4 4 4 4 4 4 4 4 4 4 4 4 4 4 4 4 4 4 12 12 12 12 12 
4 4 4 4 4 4 4 4 4 4 4 4 4 1 1 4 4 4 4 4 4 4 4 4 12 12 12 4 4 4 4 4 4 4 4 4 4 4 1 1 4 4 4 1 1 1 1 4 4 4 1 1 1 1 4 4 4 4 4 4 4 4 4 4 4 4 4 4 4 4 4 4 4 4 4 12 12 12 12 12 
4 4 4 4 4 4 4 4 4 4 4 4 4 4 1 1 4 4 4 4 4 4 4 4 4 4 4 4 4 4 1 1 4 4 4 4 4 4 1 1 4 4 4 4 4 4 4 4 1 1 1 1 4 4 4 4 4 4 4 4 4 4 4 4 4 4 4 4 4 4 4 4 4 4 4 12 12 12 12 12 
4 4 4 4 4 4 4 4 4 4 4 4 4 4 1 1 1 1 1 1 4 4 4 4 4 4 4 4 1 1 1 1 4 4 4 4 4 4 4 4 4 4 4 4 1 1 4 4 1 1 4 4 4 4 4 4 4 4 4 4 4 4 4 4 4 4 4 4 4 4 4 4 4 4 4 12 12 12 12 12 
4 4 4 4 4 4 4 4 4 4 4 4 4 4 4 4 1 1 1 1 1 1 1 1 1 1 4 4 1 1 4 4 4 4 4 4 4 4 4 4 4 4 4 4 1 1 4 4 4 4 4 4 4 4 4 1 1 4 4 4 4 4 4 4 4 1 1 4 4 4 4 4 4 4 4 12 12 12 12 12 
4 4 4 4 4 4 4 4 4 4 4 4 4 4 4 4 4 4 4 4 1 1 1 1 1 1 4 4 4 4 4 4 1 1 4 4 4 4 4 4 4 1 1 4 4 4 4 4 4 4 4 4 4 4 4 1 1 4 4 4 4 4 4 4 4 1 1 4 4 4 4 4 4 4 4 4 4 4 4 4 
4 4 4 4 4 4 4 4 4 4 4 4 4 4 4 4 4 4 4 4 4 4 4 4 4 1 1 1 1 5 1 1 1 1 4 4 4 4 4 1 1 1 1 1 1 4 4 1 1 4 4 4 1 1 4 4 4 4 4 4 4 4 4 4 4 4 4 4 4 1 1 4 4 1 1 4 4 4 1 1 
4 4 4 4 4 4 4 4 4 4 4 4 4 4 4 4 4 4 4 4 4 4 4 4 4 1 1 1 4 5 1 1 4 1 1 4 4 1 1 1 1 4 4 1 1 1 1 1 1 4 1 1 1 1 1 1 4 4 4 4 1 1 4 4 4 4 4 4 4 1 1 1 1 1 1 4 1 1 1 1 
4 4 4 4 4 4 4 4 4 4 4 4 4 4 4 4 4 4 4 4 4 4 4 4 4 4 4 5 5 1 4 4 4 1 1 1 1 1 1 4 4 4 4 4 4 1 1 4 1 1 1 1 4 4 1 1 1 1 1 1 1 1 1 1 1 1 1 1 1 1 4 1 1 4 1 1 1 1 4 4 
4 4 4 4 4 4 4 4 4 4 4 4 4 4 4 4 4 4 4 4 4 4 4 4 4 4 4 4 4 4 4 4 4 4 4 1 1 4 4 4 4 4 4 4 4 4 4 4 1 1 4 4 4 4 4 4 1 1 1 1 4 4 1 1 1 1 1 1 1 1 4 4 4 4 1 1 4 4 4 4 
