Connections;up:OLDALE TOWN (0.10);down:LITTLEROOT TOWN (0.9);
Exits;
1 1 1 1 1 1 1 1 12 12 12 12 1 1 1 1 1 1 1 1 
1 1 1 1 1 1 1 1 12 12 12 12 1 1 1 1 1 1 1 1 
1 1 12 12 12 12 12 12 12 12 12 12 12 12 12 12 1 1 1 1 
1 13 12 12 12 12 12 12 12 12 12 12 12 12 12 12 1 1 1 1 
12 12 12 12 12 12 12 12 12 12 12 12 12 12 12 12 12 12 1 1 
12 12 12 12 12 12 12 12 12 12 12 12 12 12 12 12 12 12 1 1 
1 1 12 12 12 12 1 1 1 1 1 1 1 12 12 12 12 12 12 12 
1 1 1 1 1 1 1 12 12 12 12 1 1 1 1 12 12 12 12 12 
1 1 12 12 12 12 12 12 12 12 12 1 1 1 1 12 12 12 12 12 
1 1 1 1 12 1 12 12 12 12 12 1 1 12 12 12 12 12 12 12 
1 1 1 1 12 12 12 12 12 12 12 12 12 12 12 12 12 12 12 12 
1 1 1 1 12 12 12 12 12 12 12 12 12 12 12 12 12 12 12 12 
1 1 1 1 12 12 12 12 12 12 12 12 12 12 12 12 12 12 12 12 
1 1 12 12 12 12 12 12 1 1 1 1 12 12 12 12 12 12 12 12 
12 12 12 12 12 12 12 12 12 12 12 12 1 1 12 12 12 12 1 1 
12 12 12 12 12 12 12 12 12 12 12 12 1 1 12 12 12 12 1 1 
1 1 12 12 12 12 12 12 12 12 12 12 1 1 1 1 1 1 1 1 
1 1 12 12 12 12 12 12 12 12 12 12 1 1 1 1 1 1 1 1 
1 1 1 1 1 1 1 1 1 1 12 12 1 1 1 1 1 1 1 1 
1 1 1 1 1 1 1 1 1 1 12 12 1 1 1 1 1 1 1 1 
