connections=[
		],
events={
	
		'exits':[{'name':'ROUTE 114 (0.29)','x':5,'y':7},{'name':'ROUTE 114 (0.29)','x':6,'y':7},		],
	
		'NPCs':[
			{'is_trainer':0,'b1':1,'b2':0,'sprite':'20','x':5,'y':4},
		],
	
		'signs':[
			{'x':5,'y':1},
			{'x':8,'y':1},
			{'x':7,'y':1},
		],
	
		'triggers':[
		],

},
partial_map=[
	[1, 1, 1, 1, 1, 1, 1, 1, 1, 1, 1, ],
	[1, 1, 1, 1, 1, 1, 1, 1, 1, 1, 1, ],
	[1, 12, 1, 12, 12, 12, 12, 12, 12, 1, 12, ],
	[1, 1, 1, 12, 1, 12, 1, 1, 12, 1, 12, ],
	[1, 12, 12, 12, 1, 12, 1, 1, 12, 1, 1, ],
	[1, 1, 1, 12, 1, 12, 1, 1, 12, 12, 12, ],
	[1, 1, 1, 12, 12, 12, 12, 12, 12, 1, 1, ],
	[1, 1, 1, 12, 12, 0, 0, 1, 1, 1, 1, ],
]
