connections=[
		],
events={
	{
		exits:[ROUTE 117 (0.32),ROUTE 117 (0.32),		]},
	{
		NPCs:[
			{is_trainer:0,b1:8,b2:0,sprite:30},
		]},
	{
		signs:[
		]},
	{
		triggers:[
		]},

},
[
	[1, 1, 1, 1, 1, 1, 1, 1, 1, 1, 1, 1, ],
	[1, 1, 0, 1, 1, 1, 1, 1, 1, 1, 1, 1, ],
	[12, 12, 12, 12, 1, 1, 1, 12, 12, 12, 12, 12, ],
	[1, 1, 1, 1, 1, 12, 12, 12, 12, 12, 12, 12, ],
	[12, 12, 12, 12, 12, 12, 12, 12, 12, 12, 12, 12, ],
	[12, 12, 12, 12, 12, 12, 12, 12, 12, 12, 1, 1, ],
	[1, 12, 12, 12, 12, 12, 12, 12, 12, 12, 1, 1, ],
	[12, 12, 12, 12, 12, 12, 1, 12, 12, 12, 12, 12, ],
	[1, 12, 0, 0, 12, 12, 1, 1, 1, 1, 1, 1, ],
]
