connections=[
		],
events={
	
		'exits':[{'name':'ROUTE 104 (0.19)','x':2,'y':8},{'name':'ROUTE 104 (0.19)','x':3,'y':8},		],
	
		'NPCs':[
			{'is_trainer':0,'b1':10,'b2':0,'sprite':'20','x':0,'y':3},
			{'is_trainer':0,'b1':5,'b2':0,'sprite':'14','x':7,'y':3},
			{'is_trainer':0,'b1':2,'b2':0,'sprite':'8','x':11,'y':6},
		],
	
		'signs':[
		],
	
		'triggers':[
		],

},
partial_map=[
	[1, 1, 1, 1, 1, 1, 1, 1, 1, 1, 1, 1, 1, 1, 1, ],
	[1, 1, 1, 1, 1, 1, 1, 1, 1, 1, 1, 1, 1, 1, 1, ],
	[12, 1, 12, 12, 12, 12, 12, 1, 1, 12, 1, 1, 1, 1, 12, ],
	[12, 1, 12, 12, 12, 12, 12, 12, 12, 12, 12, 1, 1, 12, 12, ],
	[12, 1, 12, 12, 12, 12, 12, 12, 12, 12, 12, 12, 12, 12, 12, ],
	[1, 1, 12, 12, 12, 12, 1, 1, 12, 12, 12, 12, 1, 1, 1, ],
	[12, 12, 12, 12, 12, 1, 1, 1, 1, 12, 12, 12, 1, 1, 1, ],
	[1, 12, 12, 12, 12, 1, 1, 1, 1, 12, 12, 12, 1, 1, 1, ],
	[1, 12, 0, 0, 12, 12, 12, 12, 12, 12, 12, 12, 12, 12, 12, ],
]
