Connections;
Exits;ROUTE 116 (0.31);ROUTE 116 (0.31);
1 1 1 1 1 1 1 1 1 1 
1 1 1 1 1 1 1 1 1 1 
12 12 12 12 12 12 12 12 12 12 
12 12 12 12 12 12 12 12 12 12 
12 1 1 12 12 12 12 1 1 12 
12 1 1 12 12 12 12 1 1 12 
12 12 12 12 12 12 12 12 12 12 
12 12 12 12 12 12 12 12 12 12 
12 12 12 12 0 0 12 12 12 12 
