Connections;
Exits;ROUTE 110 (29.0);ROUTE 110 (29.0);ROUTE 110 (29.1);
1 1 1 1 1 1 1 1 1 1 1 1 1 1 1 
1 1 1 1 1 1 1 1 1 1 1 1 1 13 1 
1 1 12 12 12 1 1 1 1 1 1 12 12 12 12 
1 12 12 12 12 12 1 1 1 1 1 12 1 1 1 
12 12 12 12 12 12 12 1 1 1 12 12 12 1 1 
12 12 12 12 12 12 12 1 1 12 12 12 12 12 1 
12 12 12 12 12 12 12 1 12 12 12 12 12 12 12 
12 12 12 12 12 12 12 12 12 12 12 12 12 12 12 
12 12 12 12 12 12 12 1 12 12 12 12 12 12 12 
1 12 12 12 12 12 1 1 12 12 12 12 12 12 12 
1 12 12 12 12 12 1 1 12 12 12 12 12 12 12 
1 12 12 12 12 12 1 1 1 12 12 12 12 12 1 
1 1 12 12 12 1 1 1 1 12 12 12 12 12 1 
1 1 12 12 12 1 1 1 1 12 12 12 12 12 1 
1 1 1 12 1 1 1 1 1 1 12 12 12 1 1 
1 1 12 12 12 1 1 1 1 1 12 12 12 1 1 
1 12 12 12 12 12 1 1 1 1 1 12 1 1 1 
12 12 12 12 12 12 12 1 1 1 12 12 12 1 1 
1 12 12 12 12 12 1 1 1 12 12 12 12 12 1 
1 1 12 12 12 1 1 1 12 12 12 12 12 12 12 
12 12 12 12 1 1 1 1 1 12 12 12 12 12 1 
12 12 1 1 1 1 1 1 1 1 12 1 12 1 1 
