connections=[
		],
events={
	{
		exits:[ROUTE 110 (29.0),ROUTE 110 (29.0),ROUTE 110 (29.1),ROUTE 110 (29.9),ROUTE 110 (29.9),ROUTE 110 (29.9),ROUTE 110 (29.9),ROUTE 110 (29.9),ROUTE 110 (29.9),ROUTE 110 (29.9),ROUTE 110 (29.9),ROUTE 110 (29.9),ROUTE 110 (29.9),		]},
	{
		NPCs:[
			{is_trainer:1,b1:10,b2:0,sprite:37},
			{is_trainer:1,b1:7,b2:0,sprite:47},
			{is_trainer:1,b1:9,b2:0,sprite:40},
			{is_trainer:0,b1:1,b2:0,sprite:59},
			{is_trainer:1,b1:8,b2:0,sprite:37},
			{is_trainer:1,b1:7,b2:0,sprite:47},
			{is_trainer:1,b1:9,b2:0,sprite:48},
			{is_trainer:0,b1:1,b2:0,sprite:224},
			{is_trainer:0,b1:1,b2:0,sprite:224},
		]},
	{
		signs:[
			{x:6,y:17},
		]},
	{
		triggers:[
			{x:8,y:19,flag:16385,scriptPointer:2548507},
			{x:0,y:14,flag:16385,scriptPointer:2548529},
			{x:6,y:6,flag:16385,scriptPointer:2548551},
			{x:9,y:7,flag:16385,scriptPointer:2548573},
		]},

},
[
	[1, 1, 1, 1, 1, 1, 1, 1, 1, 1, 1, 1, 1, 1, 1, ],
	[1, 1, 1, 1, 1, 1, 1, 1, 1, 1, 1, 1, 1, 13, 1, ],
	[1, 12, 12, 1, 12, 12, 1, 12, 12, 12, 0, 0, 12, 12, 1, ],
	[1, 0, 0, 1, 0, 12, 1, 0, 12, 12, 0, 0, 1, 1, 1, ],
	[1, 12, 12, 1, 12, 12, 1, 1, 1, 1, 1, 1, 1, 0, 1, ],
	[1, 12, 12, 1, 12, 1, 1, 1, 1, 12, 12, 12, 1, 12, 1, ],
	[1, 12, 12, 0, 0, 12, 0, 12, 1, 1, 1, 12, 1, 12, 1, ],
	[1, 1, 1, 0, 0, 1, 12, 12, 12, 0, 12, 12, 1, 12, 1, ],
	[12, 12, 12, 12, 1, 1, 1, 1, 1, 1, 1, 12, 1, 12, 1, ],
	[12, 1, 1, 1, 1, 12, 12, 12, 12, 12, 12, 12, 1, 12, 1, ],
	[12, 1, 12, 12, 12, 12, 12, 1, 1, 1, 12, 12, 1, 12, 1, ],
	[0, 1, 12, 1, 1, 1, 1, 1, 12, 1, 1, 12, 1, 0, 1, ],
	[1, 1, 12, 1, 12, 12, 1, 1, 0, 12, 1, 12, 1, 1, 1, ],
	[12, 12, 12, 1, 0, 12, 1, 1, 12, 1, 1, 12, 1, 12, 1, ],
	[0, 12, 12, 1, 1, 1, 1, 1, 1, 1, 12, 12, 12, 12, 1, ],
	[12, 12, 12, 12, 12, 12, 12, 12, 12, 12, 12, 12, 1, 12, 1, ],
	[1, 1, 1, 1, 1, 1, 1, 1, 1, 1, 1, 12, 1, 12, 1, ],
	[1, 0, 12, 0, 0, 12, 1, 1, 0, 0, 1, 12, 1, 12, 1, ],
	[1, 1, 1, 0, 0, 1, 1, 1, 0, 0, 1, 12, 12, 12, 1, ],
	[12, 12, 1, 1, 1, 1, 12, 12, 0, 12, 12, 12, 1, 12, 1, ],
	[12, 12, 12, 12, 1, 1, 12, 1, 0, 0, 1, 12, 1, 12, 1, ],
	[12, 12, 12, 12, 12, 12, 12, 1, 0, 0, 1, 1, 1, 1, 1, ],
]
