Connections;left:VERDANTURF TOWN (0.14);right:MAUVILLE CITY (0.2);
Exits;ROUTE 117 (22.0);
1 1 1 1 1 1 1 1 1 1 1 1 1 1 1 1 1 1 1 1 1 1 1 1 1 1 1 1 1 1 1 1 1 0 0 0 1 1 12 12 12 12 12 12 12 12 12 12 12 12 12 12 12 12 12 12 12 12 12 12 
1 1 1 1 1 1 1 1 12 12 12 12 1 1 1 1 1 1 12 12 12 12 4 4 4 4 4 4 4 1 1 1 13 13 12 13 12 13 12 12 12 12 12 12 12 12 12 13 12 12 12 12 12 12 12 12 12 12 12 12 
1 1 1 1 1 1 1 1 12 12 12 12 12 12 12 12 12 12 12 12 12 12 4 4 4 4 4 4 4 4 1 1 13 13 13 13 12 13 13 12 12 12 12 12 12 12 12 12 12 12 12 12 12 12 12 12 12 12 12 12 
1 1 1 1 1 1 1 1 1 1 1 1 1 1 1 12 12 12 12 12 12 12 4 4 4 4 4 4 4 4 4 1 13 12 12 13 13 13 12 12 12 12 12 12 12 12 12 12 12 12 1 1 1 1 12 12 13 12 12 12 
1 1 1 1 1 1 1 1 12 12 12 12 12 12 1 12 12 12 12 12 12 12 4 4 4 4 4 4 4 4 4 1 13 13 13 13 12 12 12 12 12 13 12 12 12 12 12 12 12 12 1 1 1 1 12 12 12 12 12 12 
1 1 1 1 1 1 1 1 12 12 12 12 12 12 1 12 12 12 12 12 12 12 12 12 12 12 4 4 4 4 4 1 1 1 1 1 1 1 1 1 1 1 1 1 1 1 1 12 1 1 1 1 1 1 1 1 1 1 1 1 
12 1 1 1 1 1 12 1 12 12 12 12 12 12 1 12 1 12 12 12 12 12 12 12 12 12 4 4 4 4 4 12 12 12 12 12 12 12 12 12 12 12 12 12 12 12 12 12 12 12 12 12 12 12 12 12 12 12 12 12 
1 1 1 1 1 1 1 1 1 12 12 12 12 1 1 12 12 12 12 12 12 12 12 12 12 12 12 12 4 4 4 12 12 12 12 12 12 12 12 12 12 12 12 12 12 12 12 12 12 12 12 12 12 12 12 12 12 12 12 12 
12 12 12 12 12 12 12 12 12 12 12 12 12 12 12 12 12 12 12 12 12 12 12 12 12 12 12 12 12 12 12 12 12 12 12 12 12 12 12 12 12 12 12 12 12 12 12 12 12 12 12 12 12 12 12 12 12 12 12 12 
12 12 12 12 12 12 12 12 12 12 12 12 12 12 12 12 12 12 12 12 12 12 12 12 12 12 12 12 12 12 12 12 12 12 12 12 12 12 12 1 1 1 1 1 1 1 1 12 12 12 12 12 12 12 12 12 12 12 12 12 
12 12 12 12 12 12 12 12 0 0 0 0 0 0 0 0 12 12 12 12 4 4 4 12 12 12 12 12 12 12 12 12 12 12 12 12 12 12 12 1 1 1 1 1 1 1 1 12 12 12 12 12 12 12 12 12 12 12 12 12 
12 12 12 12 12 12 12 12 12 12 12 12 12 12 12 12 12 12 12 12 4 4 4 4 12 12 12 12 12 12 12 12 12 12 12 12 12 12 1 1 1 1 1 1 1 1 1 1 12 12 12 12 12 12 12 12 12 12 12 12 
12 12 12 12 12 12 12 12 12 12 12 12 12 12 12 12 12 12 12 12 4 4 4 4 4 4 12 12 12 12 12 12 12 12 12 12 12 12 1 1 1 1 1 1 1 1 1 1 12 1 12 12 12 12 12 12 12 12 12 12 
1 1 1 1 1 1 1 1 1 1 1 12 12 12 1 1 1 12 12 12 4 4 4 4 4 4 12 12 12 12 12 12 12 12 12 12 12 12 1 1 12 13 13 13 12 1 1 12 12 12 12 12 12 12 12 12 12 12 1 1 
12 12 1 1 1 1 12 12 1 12 12 12 12 12 12 12 1 12 12 12 4 4 4 4 4 4 4 4 12 12 12 12 12 12 12 12 12 12 1 1 12 12 12 12 12 1 1 12 12 12 12 12 12 12 12 1 1 1 1 1 
12 1 1 1 1 1 1 1 1 12 12 12 12 12 12 12 1 12 12 12 4 4 4 4 4 4 4 4 12 12 12 12 12 12 12 12 12 12 12 12 12 12 12 12 12 12 12 12 12 12 12 12 12 1 1 1 1 1 1 1 
1 1 1 1 1 1 1 1 1 12 12 12 12 12 12 12 1 12 12 12 4 4 4 4 4 4 4 4 12 12 12 12 12 12 12 12 12 12 12 12 12 12 12 12 12 12 12 12 12 12 12 12 12 1 1 1 1 1 1 1 
1 1 1 1 1 1 1 1 1 12 1 1 1 1 1 1 1 1 1 1 4 4 4 4 4 4 4 4 12 12 12 12 12 12 12 12 12 12 12 12 12 12 12 12 12 12 12 12 12 12 12 12 1 1 1 1 1 1 1 1 
1 1 1 12 12 12 12 12 12 12 12 12 12 12 12 12 12 1 1 1 12 1 1 1 1 1 1 12 1 1 12 12 12 12 12 12 12 12 12 12 12 12 12 12 12 12 12 12 12 12 12 1 1 1 1 1 1 1 1 1 
1 1 1 1 12 1 1 1 1 1 12 1 1 1 1 1 12 1 1 1 1 1 1 1 1 1 1 1 1 1 1 1 12 12 12 12 12 1 1 1 1 1 1 1 1 1 1 1 12 12 1 1 1 1 1 1 1 1 1 1 
