Connections;left:ROUTE 133 (0.48);right:PACIFIDLOG TOWN (0.15);
Exits;
4 4 1 1 4 4 4 1 1 1 1 4 4 1 1 5 5 5 5 5 5 4 4 4 4 4 4 4 4 4 4 4 4 4 4 4 4 1 1 1 1 4 4 4 4 4 4 1 1 4 4 1 1 4 4 4 4 4 4 4 1 1 5 5 5 5 4 4 4 1 1 1 1 1 1 1 1 1 1 1 
1 1 1 1 4 4 4 1 1 1 1 1 1 1 1 5 4 4 5 5 5 1 1 4 4 4 4 4 4 1 1 4 4 1 1 4 4 1 1 1 1 1 1 4 4 1 1 1 1 1 1 1 1 5 5 5 1 1 4 4 1 1 5 4 4 5 4 4 4 1 1 1 1 1 1 1 1 1 1 1 
1 1 4 4 5 5 5 4 4 4 4 1 1 5 5 5 5 5 5 4 4 1 1 1 1 1 1 1 1 1 1 1 1 1 1 1 1 4 4 4 4 1 1 1 1 1 1 4 4 1 1 4 4 5 4 5 1 1 1 1 4 4 5 5 5 5 4 4 4 1 1 1 1 1 1 1 1 1 1 1 
4 4 4 4 5 4 5 4 4 4 4 4 4 5 5 4 4 4 4 4 4 4 4 1 1 1 1 1 1 4 4 1 1 4 4 1 1 4 4 4 4 4 4 1 1 4 5 5 4 4 4 4 4 5 5 5 4 4 1 1 4 4 4 4 4 4 1 1 4 4 1 1 1 1 1 1 1 1 1 1 
4 4 4 4 5 5 5 4 5 5 4 4 4 4 4 4 4 4 4 4 4 4 4 4 4 4 4 4 4 4 4 4 4 4 4 4 4 4 4 4 4 4 4 4 4 4 5 5 4 4 4 4 4 4 4 4 4 4 4 4 4 4 4 4 4 4 1 1 4 4 4 1 1 1 1 1 1 1 1 1 
4 4 4 4 4 4 4 4 5 5 4 4 4 4 4 4 4 4 4 4 4 4 4 4 4 4 4 4 4 4 4 4 4 4 4 4 4 4 4 4 4 4 4 4 5 5 4 4 4 4 4 4 4 4 4 4 4 4 4 4 4 4 4 4 4 4 4 1 1 4 4 1 1 4 1 1 1 1 1 1 
4 4 4 4 4 4 4 4 4 4 4 4 4 4 4 5 5 4 4 4 4 4 4 4 4 5 5 4 4 4 4 4 4 4 4 4 4 4 4 4 4 4 4 4 5 5 4 4 4 4 4 4 4 4 4 4 4 4 4 4 4 4 4 4 4 4 4 1 1 1 1 1 1 4 4 4 4 1 1 1 
4 4 4 4 4 4 4 4 4 4 4 5 5 5 5 5 5 4 4 4 4 4 4 4 4 5 5 4 5 5 4 4 4 4 4 4 4 4 4 4 4 4 4 4 5 5 4 4 4 4 4 5 5 4 4 4 4 4 4 4 4 4 4 4 4 4 4 4 4 1 1 4 4 5 5 4 4 4 4 4 
4 4 4 4 4 4 4 4 4 5 5 5 5 5 5 4 4 4 4 4 4 4 4 4 4 4 4 4 5 5 5 5 4 4 4 4 4 4 4 4 4 4 4 4 5 5 4 4 4 4 4 5 5 5 5 4 4 4 4 4 4 4 4 4 4 4 4 4 4 4 4 4 4 5 5 4 4 4 4 4 
4 4 4 4 4 5 5 5 5 5 5 4 12 12 4 4 4 4 4 4 4 4 4 4 4 4 4 4 4 4 5 5 4 5 5 4 4 4 4 4 4 4 4 5 5 4 4 5 5 5 5 5 5 5 5 4 4 4 4 4 4 4 4 4 4 4 4 4 4 4 4 5 5 5 4 4 5 5 4 4 
4 4 4 4 4 5 5 5 5 4 12 12 12 12 4 4 4 4 4 4 4 4 4 4 4 4 4 4 4 4 4 4 4 5 5 4 4 4 4 4 4 5 5 5 5 4 4 5 5 5 5 5 5 4 4 4 4 4 4 4 4 4 4 4 4 4 4 4 4 4 4 5 4 5 4 4 5 5 4 4 
4 4 4 4 4 12 12 12 12 12 12 12 12 12 12 4 4 4 4 4 4 4 4 4 4 4 4 4 4 4 4 4 4 4 4 4 5 5 4 4 4 5 5 4 4 4 4 4 4 4 4 4 4 4 4 4 4 4 4 4 4 4 4 4 4 4 4 4 4 4 4 5 5 5 4 4 4 4 4 4 
4 4 4 4 12 12 12 12 12 12 12 12 12 12 12 4 4 4 4 4 4 1 1 4 4 4 4 4 4 4 4 4 4 4 4 4 5 5 4 4 4 4 4 4 4 4 4 4 4 4 4 4 4 4 4 4 4 4 4 4 4 4 4 4 4 4 4 4 4 4 4 4 4 5 5 5 5 5 5 4 
4 4 4 4 12 1 1 1 1 1 1 1 12 12 12 4 4 4 4 4 4 1 1 4 4 4 4 4 4 4 4 4 4 4 4 5 5 4 4 4 4 4 4 4 4 4 4 4 4 4 4 4 5 5 4 4 4 4 4 4 4 4 4 4 4 4 4 4 4 4 4 4 4 5 5 5 5 4 5 4 
4 4 4 4 1 0 1 1 1 1 1 1 1 1 1 4 4 4 4 4 4 4 4 4 4 1 1 4 4 4 4 4 4 4 4 5 5 4 4 4 4 4 4 4 4 4 4 4 4 4 5 5 5 5 4 4 4 4 4 4 4 4 4 4 4 4 4 4 4 4 4 4 4 4 4 4 5 5 5 4 
4 4 4 4 1 1 1 12 12 12 12 12 1 1 1 4 4 4 4 4 1 1 4 4 4 1 1 4 4 4 4 4 4 4 4 4 5 5 4 4 4 4 4 4 4 4 4 4 4 4 5 5 4 5 5 5 5 4 4 4 4 4 4 4 4 4 4 4 4 4 4 4 4 4 4 4 4 4 4 4 
4 4 4 4 4 12 12 12 12 12 12 12 12 12 12 4 4 4 4 4 1 1 1 1 4 4 4 4 4 4 4 4 4 4 4 4 5 5 4 4 4 4 4 4 4 4 4 4 5 5 4 4 4 5 5 5 5 4 5 5 5 5 4 4 4 4 4 4 4 4 4 4 4 4 4 4 4 4 4 4 
4 4 4 4 4 4 12 12 4 4 4 12 12 12 12 4 4 4 4 4 4 4 1 1 4 4 4 4 1 1 4 4 4 4 4 4 4 4 4 4 4 4 4 4 4 4 4 4 5 5 4 4 4 5 5 4 4 4 5 5 5 5 5 5 5 5 4 4 4 4 4 4 4 4 4 4 4 4 4 4 
4 4 4 4 4 4 4 4 4 4 4 4 4 4 4 4 4 4 4 4 4 4 4 4 4 4 4 4 1 1 4 4 4 4 4 4 4 4 4 4 4 4 4 4 4 4 4 4 4 4 4 4 4 5 5 4 4 4 4 4 4 4 5 5 5 5 4 4 4 4 4 4 4 4 4 4 4 4 4 4 
4 4 4 4 4 4 4 4 4 4 4 4 4 4 4 4 4 4 4 4 4 4 4 4 4 4 4 4 4 4 4 4 4 4 4 4 4 4 4 4 4 4 4 4 4 4 4 4 4 4 4 4 4 4 4 4 4 4 4 4 4 4 4 4 4 4 4 4 4 4 4 4 4 4 4 4 4 4 4 4 
4 4 4 4 4 4 4 4 4 4 4 4 4 4 4 4 4 4 4 4 4 4 4 4 4 4 4 4 4 4 4 4 4 4 4 4 4 4 4 4 4 4 4 4 4 4 4 4 4 4 4 4 4 4 4 4 4 4 4 4 4 4 4 4 4 4 4 4 4 4 4 4 4 4 4 4 4 4 4 4 
4 4 4 4 4 4 4 4 4 4 4 4 4 4 4 4 4 4 4 4 4 4 4 4 4 4 4 4 4 4 4 4 4 4 4 4 4 4 4 4 4 4 4 4 4 4 4 4 4 4 4 4 4 4 4 4 4 4 4 4 4 4 4 4 4 4 4 4 4 4 4 4 4 4 4 4 4 4 4 4 
1 1 1 1 4 4 4 1 1 4 4 4 4 4 4 4 4 4 4 4 4 4 4 4 4 4 4 4 4 4 12 12 12 12 4 4 4 4 4 4 4 4 4 4 4 12 12 12 12 12 12 12 12 12 12 12 12 12 4 5 5 4 5 5 4 4 4 4 4 4 4 4 4 4 4 4 4 4 4 4 
1 1 1 1 1 1 4 1 1 4 4 4 4 4 4 4 4 4 4 4 4 4 4 4 4 4 4 4 4 4 12 12 12 12 4 4 4 4 4 4 4 4 4 4 12 12 12 12 12 12 12 13 13 12 13 13 12 12 4 5 5 4 5 5 4 4 4 4 4 4 4 4 4 4 4 4 4 4 4 4 
4 4 4 4 1 1 1 1 4 4 4 4 4 4 4 4 4 4 4 12 12 12 12 12 12 12 12 12 12 12 12 12 12 12 4 4 4 4 4 4 4 4 4 12 12 12 12 13 13 12 12 13 13 12 13 13 4 4 4 4 4 4 4 4 4 4 4 4 4 4 4 4 4 4 4 4 4 4 4 4 
4 4 4 4 4 4 1 1 4 4 4 4 4 4 4 4 4 4 4 12 12 12 12 12 12 12 12 12 12 12 12 12 12 12 4 4 4 4 4 4 4 4 12 12 12 12 12 13 13 12 12 13 13 4 4 4 4 4 4 4 4 4 4 4 4 4 4 4 4 4 4 4 4 4 4 4 4 4 4 4 
4 4 4 4 4 4 1 1 4 4 4 4 4 4 4 4 4 4 4 12 12 12 12 4 4 4 4 4 4 4 4 4 12 12 4 4 4 4 4 4 4 12 12 12 12 12 12 12 12 13 13 4 4 4 4 4 4 4 4 4 4 4 4 4 4 4 4 4 4 4 4 4 4 4 4 4 4 4 4 4 
4 4 4 4 4 4 1 1 4 4 4 4 4 4 4 4 4 4 4 12 12 12 12 4 4 4 4 4 4 4 4 4 12 12 4 4 4 4 4 4 4 13 13 12 12 12 12 12 12 13 13 4 4 4 4 4 4 4 4 4 4 4 4 4 4 4 4 4 4 4 4 4 4 4 4 4 4 4 4 4 
4 4 4 4 4 1 1 4 4 4 4 4 4 4 4 4 4 4 4 12 12 12 12 4 4 4 4 4 4 4 4 4 12 12 12 12 4 4 4 4 4 13 13 12 13 13 12 12 12 12 12 4 4 4 4 4 4 4 4 4 4 4 4 4 4 4 4 4 4 4 4 4 5 5 5 5 4 4 4 4 
4 4 4 4 4 1 1 4 4 4 4 4 4 4 4 4 4 4 4 4 4 12 12 4 4 4 4 4 4 4 4 4 4 12 12 12 4 4 4 4 4 4 12 12 13 13 12 12 12 12 12 4 4 4 4 4 4 4 4 4 4 4 4 4 4 4 4 4 4 4 4 4 5 4 4 5 4 4 4 4 
4 4 4 4 1 1 4 4 4 4 4 4 4 4 4 4 4 4 4 4 4 12 12 12 4 4 4 4 4 4 4 4 4 12 12 12 4 4 4 4 4 4 4 12 12 13 13 12 12 12 12 12 12 4 4 4 4 4 4 4 4 4 4 4 4 4 4 4 4 4 5 5 5 5 5 5 5 5 4 4 
4 4 1 1 1 1 4 4 4 4 4 4 4 4 4 4 4 4 4 4 4 12 12 12 12 12 12 12 12 12 12 12 12 12 12 12 4 4 4 4 4 4 4 12 12 13 13 12 12 12 12 13 13 12 4 4 4 4 4 4 4 4 4 4 4 4 4 4 4 4 5 5 4 4 4 4 5 5 4 4 
1 1 1 1 4 4 4 4 4 4 4 4 4 4 4 4 4 4 4 4 4 12 12 12 12 12 12 12 12 12 12 12 12 12 12 12 4 4 4 4 4 4 4 12 12 12 12 12 12 12 12 13 13 12 12 12 4 4 4 4 4 4 4 4 4 4 4 4 4 4 4 4 4 4 4 4 4 4 1 1 
1 1 4 4 4 4 4 4 4 4 4 4 4 4 4 4 4 4 4 4 4 12 12 12 12 4 4 4 4 4 4 4 4 4 4 4 4 4 4 4 4 4 4 4 12 13 13 12 12 12 12 12 12 12 13 13 12 12 4 4 4 4 4 4 4 4 4 4 4 4 4 4 1 1 4 1 1 1 1 1 
4 4 4 4 4 4 4 4 4 4 4 4 4 4 4 4 4 4 4 4 4 12 12 12 12 4 4 4 4 4 4 4 4 4 4 4 4 4 4 4 4 4 4 4 4 13 13 12 12 12 12 12 12 12 13 13 12 12 4 4 4 4 4 4 5 5 4 4 5 5 4 4 1 1 1 1 1 1 1 1 
4 4 4 4 4 4 4 4 4 4 4 4 4 4 4 4 4 4 4 4 4 4 4 4 4 4 4 4 4 1 1 4 4 4 4 4 4 4 4 4 4 4 4 4 4 4 4 4 4 4 4 4 4 4 4 4 4 4 4 4 4 4 4 4 5 5 1 1 5 5 1 1 4 1 1 1 1 1 1 1 
1 1 4 4 4 4 4 4 4 4 4 4 1 1 4 4 4 4 1 1 4 4 1 1 4 4 4 1 1 1 1 4 4 4 4 1 1 4 1 1 4 4 1 1 4 4 1 1 4 4 1 1 4 4 4 4 4 1 1 1 1 4 1 1 1 1 1 1 4 4 1 1 1 1 1 1 1 1 1 1 
1 1 4 4 1 1 4 4 1 1 1 1 1 1 1 1 1 1 1 1 1 1 1 1 1 1 4 1 1 4 1 1 1 1 4 1 1 4 1 1 1 1 1 1 1 1 1 1 1 1 1 1 5 5 5 1 1 1 1 1 1 4 1 1 1 1 4 4 4 4 1 1 1 1 1 1 1 1 1 1 
4 4 1 1 1 1 1 1 1 1 1 1 4 4 1 1 1 1 4 4 1 1 4 4 1 1 1 1 4 4 1 1 1 1 1 1 4 1 1 4 1 1 4 4 1 1 4 4 1 1 4 4 5 4 5 1 1 4 4 4 4 1 1 4 4 4 4 4 4 1 1 1 1 1 1 1 1 1 1 1 
4 4 1 1 4 4 1 1 4 4 4 4 4 4 4 4 4 4 4 4 4 4 4 4 4 4 1 1 4 4 4 4 4 4 1 1 4 1 1 4 4 4 4 4 4 4 4 4 4 4 4 4 5 5 5 4 4 4 4 4 4 1 1 4 4 4 4 1 1 1 1 1 1 1 1 1 1 1 1 1 
