Connections;up:MOSSDEEP CITY (0.6);down:ROUTE 128 (0.43);left:ROUTE 126 (0.41);
Exits;
5 5 13 13 13 13 5 5 5 5 5 13 13 13 13 13 13 12 13 4 13 4 5 5 5 4 4 4 4 4 4 4 4 4 4 12 1 1 1 1 1 1 1 1 4 4 4 1 1 1 1 1 1 1 1 1 1 1 5 5 4 4 4 4 4 4 4 4 4 1 1 1 1 5 4 13 13 0 5 1 
13 13 13 13 13 13 13 5 5 5 5 13 13 13 13 13 13 13 13 5 13 5 5 4 4 4 4 4 4 4 4 4 4 4 4 4 4 4 4 4 4 1 1 4 4 1 5 5 1 1 1 1 1 1 1 1 1 1 5 5 4 4 4 4 4 4 4 4 4 1 1 1 1 5 4 13 13 4 5 1 
13 13 13 13 13 13 13 5 5 5 5 5 5 5 5 13 13 13 12 13 5 5 4 4 4 4 4 4 4 4 4 4 4 4 4 4 4 4 4 4 4 1 1 1 1 5 5 5 1 1 1 1 1 1 1 1 1 1 4 1 1 1 1 1 1 1 5 4 4 4 4 5 5 5 4 13 0 13 5 1 
13 13 13 13 13 13 13 5 5 5 5 5 5 5 5 5 13 13 12 13 5 4 4 4 4 4 4 4 4 4 4 4 4 4 4 4 4 4 4 4 1 1 4 5 4 5 4 1 1 1 1 1 1 1 1 1 1 1 1 12 12 1 12 12 12 1 4 1 5 1 1 5 5 5 4 1 13 13 5 1 
13 13 13 13 13 13 13 5 5 5 5 12 12 12 12 12 5 13 13 13 5 4 4 4 4 4 4 4 4 4 4 4 4 4 4 4 4 4 4 4 1 1 4 5 4 5 4 1 5 5 1 1 1 1 1 1 1 1 1 12 12 1 12 12 12 1 12 12 5 1 1 4 4 5 1 4 13 13 5 1 
13 13 13 13 13 5 13 5 5 5 5 12 12 12 12 12 5 5 13 12 5 5 5 4 4 4 4 4 4 4 4 4 4 4 4 4 4 4 4 4 4 4 1 5 4 5 4 1 5 5 1 1 1 1 1 1 1 1 5 1 12 1 1 1 1 1 12 12 5 4 4 4 4 4 5 4 13 13 5 1 
13 13 13 13 13 13 5 5 5 12 12 12 12 12 12 12 12 4 5 12 5 5 5 4 4 4 4 4 4 4 4 4 4 4 4 4 4 4 4 4 4 1 5 4 4 5 4 1 1 1 1 1 1 1 1 1 1 5 5 1 12 12 1 1 1 1 12 1 5 4 4 4 4 4 5 4 13 13 0 5 
13 13 13 13 13 13 5 5 5 12 12 12 12 12 12 12 12 4 5 12 5 4 4 4 4 4 4 4 4 4 4 4 4 4 4 4 4 4 4 4 4 5 5 4 5 5 1 1 1 1 1 4 4 5 5 1 1 5 5 5 1 1 1 1 1 1 1 5 4 4 4 4 4 4 5 13 13 13 4 5 
5 13 13 13 5 13 5 5 5 12 12 12 12 12 12 12 12 4 5 5 5 4 4 4 4 4 4 4 4 4 4 4 4 4 4 4 4 5 5 4 1 5 5 4 5 5 5 5 1 1 1 4 4 5 5 4 4 4 4 4 4 4 4 4 4 4 4 4 4 4 4 4 4 4 4 5 13 0 13 5 
13 13 13 5 13 13 5 12 12 12 12 12 12 12 12 4 4 4 4 4 4 4 4 4 4 4 4 4 4 4 4 4 4 4 4 4 4 5 5 1 5 5 4 4 5 5 5 5 1 1 4 1 1 4 4 4 4 4 4 4 4 4 4 4 4 4 4 4 4 4 4 4 4 4 4 5 1 13 13 5 
5 5 13 13 5 5 5 12 12 12 12 12 12 12 12 4 4 4 4 4 4 4 4 4 4 4 4 4 4 4 4 4 4 4 4 4 4 4 4 1 4 5 4 1 5 5 4 4 1 1 4 1 1 4 4 4 4 4 4 4 4 4 4 4 4 4 4 4 4 4 4 4 4 4 4 5 4 13 13 5 
5 5 13 13 5 5 5 12 12 12 12 12 12 4 4 4 4 4 12 12 4 4 4 4 4 4 4 4 4 4 4 4 4 4 5 5 4 4 1 5 4 5 5 5 1 5 4 4 4 4 4 4 4 4 4 4 4 4 4 4 4 4 4 4 4 4 4 4 4 4 4 4 4 4 4 5 4 13 13 5 
5 5 5 13 5 5 5 12 12 12 12 12 12 4 4 4 4 4 12 12 12 4 4 4 4 4 4 4 4 4 4 4 4 4 5 5 5 1 5 4 4 4 1 1 5 4 4 4 4 4 4 4 4 4 4 4 4 4 4 4 4 4 4 4 4 4 4 4 4 4 4 4 4 4 4 5 13 13 13 5 
13 13 13 5 5 5 5 4 4 4 4 4 4 4 4 4 4 4 12 12 12 4 4 4 4 4 4 4 4 4 4 4 4 4 4 4 5 4 1 1 1 1 5 4 4 4 4 4 4 12 12 12 12 12 12 12 12 12 4 4 4 4 4 4 4 4 4 4 4 4 4 4 4 4 4 4 5 13 13 5 
13 13 13 5 5 5 4 4 4 4 4 4 4 4 4 4 4 4 4 4 12 4 4 4 4 4 4 4 4 4 4 4 4 5 1 1 5 4 5 5 5 4 4 4 4 4 4 4 12 12 12 12 12 12 12 12 12 12 12 12 4 4 4 4 4 4 4 4 4 4 4 4 4 4 4 4 5 13 13 5 
13 13 13 13 5 5 4 4 4 4 12 12 12 12 12 12 12 4 4 4 4 4 4 4 4 4 4 4 4 4 4 5 5 5 4 5 12 13 4 4 5 4 4 4 4 4 12 12 12 12 12 12 12 12 12 12 12 12 12 12 12 4 4 4 4 4 4 4 4 4 4 4 4 4 4 4 5 13 13 5 
13 13 5 13 5 5 5 5 4 4 12 12 12 12 12 12 12 12 4 4 4 4 4 4 4 4 4 4 4 4 4 5 5 5 5 4 12 1 1 1 5 4 4 4 4 12 12 12 12 12 12 12 1 1 1 1 12 12 12 12 12 12 12 12 4 4 4 4 4 4 4 4 4 4 4 4 5 13 13 5 
13 13 5 13 5 5 5 5 4 4 12 12 1 1 1 1 12 12 4 4 4 4 4 4 4 4 4 4 4 4 4 4 4 5 13 12 12 1 5 4 4 4 4 12 12 12 12 12 12 12 1 1 1 1 1 1 1 1 12 12 12 12 12 12 4 4 4 4 4 4 4 4 4 4 4 4 5 13 13 5 
13 13 5 13 5 5 4 4 4 4 12 12 12 1 1 1 1 12 4 4 4 4 4 4 4 4 4 4 4 4 4 4 4 1 1 4 1 1 1 4 4 4 4 12 12 12 12 12 1 1 1 1 1 1 1 1 1 1 1 1 12 12 12 12 12 4 4 4 4 4 4 4 4 4 4 4 5 13 13 5 
12 12 4 13 4 5 4 5 5 4 12 12 1 1 1 1 12 12 4 4 4 4 4 4 4 4 4 4 4 4 4 4 4 1 1 4 1 1 1 4 4 4 4 12 12 1 1 1 1 1 1 1 13 1 1 1 1 1 1 1 1 1 1 12 12 4 4 4 4 4 4 4 4 4 4 4 5 13 13 5 
13 12 4 13 4 5 4 5 5 4 12 1 1 12 12 1 1 12 4 4 4 4 4 4 4 4 4 4 4 4 4 4 4 1 1 1 1 1 4 4 4 4 12 12 1 1 1 1 1 1 1 1 1 1 1 1 1 1 1 1 1 1 1 12 12 4 4 4 4 4 4 4 4 4 4 4 5 13 13 5 
13 12 4 13 4 5 4 4 4 4 1 1 12 12 1 1 1 1 4 4 4 4 4 4 4 4 4 4 4 4 4 4 4 1 4 1 1 1 4 4 4 4 12 12 1 1 1 1 1 1 1 1 1 1 1 1 1 1 1 1 1 1 1 12 12 4 4 4 4 4 4 4 4 4 4 4 5 13 13 5 
13 12 5 13 5 5 4 4 4 4 12 1 1 12 12 1 1 12 4 4 4 4 4 4 4 4 4 4 4 4 4 4 4 1 4 4 1 1 4 4 4 4 12 12 1 1 1 1 1 1 1 12 12 1 1 1 1 1 1 1 1 12 12 12 12 4 4 4 4 4 4 4 4 4 4 4 5 13 13 5 
13 12 13 5 5 4 4 4 4 4 12 12 12 12 12 12 12 12 4 4 4 4 4 4 4 4 4 4 4 4 4 4 4 1 1 4 1 4 4 4 4 4 12 12 1 1 1 1 1 1 12 12 12 12 12 12 12 12 12 12 12 12 12 12 12 4 4 4 4 4 4 4 4 4 4 4 5 13 13 5 
13 12 13 5 4 4 4 4 4 4 4 4 12 12 12 12 12 4 4 4 5 5 4 4 4 4 4 4 4 4 4 4 4 4 1 4 1 4 4 4 4 4 4 12 1 1 1 1 12 12 12 12 12 12 12 4 4 1 1 4 4 4 4 4 4 4 4 4 4 4 4 4 4 4 4 4 5 13 13 5 
13 13 13 5 4 5 5 4 4 4 4 4 4 4 4 4 4 4 4 4 5 5 4 4 4 4 4 4 4 4 4 4 4 4 1 1 1 4 4 4 4 4 4 12 12 12 12 12 12 12 12 12 12 4 4 4 4 1 1 1 1 4 4 4 4 4 4 4 4 4 4 4 4 4 4 4 5 13 13 5 
12 13 13 5 4 5 5 4 4 4 4 4 4 4 4 4 4 4 5 1 1 4 4 4 4 4 4 4 4 4 4 4 4 4 1 1 4 4 4 4 4 4 4 4 12 12 12 12 12 4 4 4 4 4 4 4 4 4 4 1 1 4 4 4 4 4 4 4 4 4 4 4 4 4 4 4 5 13 13 5 
12 13 13 5 4 4 4 4 4 4 4 4 4 4 4 4 4 4 1 4 1 4 4 4 4 4 4 4 4 4 4 4 4 4 1 1 5 5 4 4 4 4 4 4 4 4 4 4 4 4 4 4 4 4 4 4 4 1 1 5 4 1 1 4 4 4 4 4 4 4 4 4 4 4 4 4 5 13 13 5 
13 12 5 5 4 4 4 4 4 4 4 4 4 4 4 4 4 1 5 4 1 4 4 4 4 4 4 4 4 4 4 4 4 4 1 1 5 5 4 4 4 4 4 4 4 4 4 4 4 4 4 4 4 4 4 4 4 1 4 1 4 1 1 1 1 4 4 4 4 4 4 4 4 4 4 1 1 13 13 5 
1 4 1 4 4 4 4 4 4 4 4 4 4 4 4 4 4 1 1 1 1 5 1 1 4 4 4 4 4 4 4 4 4 4 4 4 4 4 4 4 4 5 5 5 1 1 4 4 4 4 4 4 4 4 4 4 1 5 4 1 4 4 4 1 1 4 5 5 5 5 5 4 4 4 4 1 12 13 13 5 
1 1 1 4 5 5 4 4 4 4 4 4 4 4 4 4 4 1 1 1 1 1 12 5 4 4 4 4 4 4 4 4 4 4 4 4 4 4 4 4 4 5 5 1 4 1 4 4 4 4 4 4 4 4 4 4 1 1 1 1 4 4 4 4 1 1 5 5 0 5 5 4 4 4 4 1 1 0 13 5 
1 1 4 4 5 5 4 4 4 4 4 4 4 4 4 4 1 5 1 1 1 5 13 5 4 4 4 4 4 4 4 4 4 4 4 4 4 4 4 4 4 4 5 5 4 1 4 4 4 4 4 4 4 4 4 4 1 1 1 1 4 4 4 4 1 1 5 5 1 5 5 1 1 4 4 1 13 1 1 5 
4 4 4 4 4 4 4 4 4 4 4 4 4 4 4 4 1 4 1 1 5 5 4 4 4 4 4 4 4 4 4 4 4 4 4 4 4 4 4 4 4 4 1 1 1 1 4 4 4 4 4 4 4 4 4 1 5 1 1 1 4 4 4 4 4 4 5 1 5 5 5 1 1 4 4 1 13 13 1 5 
4 4 4 4 4 4 4 4 4 4 4 4 4 4 4 4 1 4 1 4 1 1 4 4 4 4 4 4 4 4 4 4 4 4 4 4 4 4 4 4 4 5 5 1 1 1 4 4 4 4 4 4 4 4 4 5 1 4 1 1 4 4 4 4 4 4 4 5 5 5 5 4 4 4 4 1 13 13 5 4 
4 4 4 4 4 4 4 4 4 4 4 4 4 4 4 4 1 4 1 4 1 1 4 4 4 4 4 4 4 4 4 4 4 4 4 4 4 4 4 4 4 1 4 1 1 1 4 4 4 4 4 4 4 4 4 5 1 1 1 1 4 4 4 12 12 12 12 12 4 4 5 5 5 4 1 5 13 13 5 4 
4 4 5 5 4 4 4 4 4 4 4 4 4 4 4 4 1 1 1 1 1 1 4 4 4 4 4 4 4 4 4 4 4 4 4 4 4 4 4 4 4 1 4 4 1 1 4 4 4 4 4 4 4 4 4 5 1 1 1 1 4 4 4 12 12 12 12 12 4 4 5 1 5 4 1 1 0 13 5 1 
4 4 5 5 4 4 4 4 4 4 4 4 4 4 4 4 4 1 4 1 1 1 4 4 4 4 4 4 4 4 4 4 4 4 4 4 4 4 4 4 4 1 1 4 1 4 4 4 4 4 4 4 4 4 4 5 1 1 1 4 4 12 12 1 1 1 1 12 12 4 4 5 1 4 1 1 1 1 1 1 
4 4 4 4 4 4 4 4 4 4 4 4 4 4 4 4 4 1 4 4 1 1 4 4 4 4 4 4 4 4 4 4 4 4 4 4 4 4 4 4 4 4 1 1 1 4 4 4 4 4 4 4 4 4 4 5 1 1 1 4 4 12 12 12 1 1 1 1 12 4 4 4 1 1 1 1 1 1 1 1 
4 4 4 4 4 4 4 4 4 4 4 4 4 4 4 4 4 1 1 4 1 4 4 4 4 4 4 4 4 4 4 4 4 4 4 4 4 4 4 4 4 4 1 1 5 5 4 4 4 4 4 4 4 4 1 5 1 1 1 4 4 12 12 1 1 1 1 12 12 12 4 4 1 1 1 4 1 1 1 1 
4 4 4 4 4 4 4 4 4 4 4 4 4 4 4 4 4 4 1 4 1 4 4 4 4 4 4 4 4 4 4 4 4 4 4 4 4 4 4 4 4 4 4 4 5 5 4 4 4 4 4 4 4 4 5 4 1 1 5 5 4 12 1 1 12 12 1 1 12 12 4 4 4 4 1 4 1 4 1 1 
4 4 4 4 4 4 4 4 4 4 4 4 4 4 4 4 4 4 1 4 1 4 4 4 4 4 4 4 4 4 4 4 4 4 4 4 4 4 4 4 4 4 4 4 4 4 4 4 4 4 4 4 4 4 5 4 1 4 1 1 4 1 1 12 12 1 1 1 1 12 4 4 4 4 1 4 1 4 1 1 
4 4 4 4 4 4 4 4 4 4 4 4 4 4 4 4 4 4 1 1 1 4 4 4 4 4 4 4 4 4 4 4 4 4 4 4 4 4 4 4 4 4 4 4 4 4 4 4 4 4 4 4 4 4 5 4 1 4 1 1 4 12 1 1 12 12 1 1 1 1 4 4 4 4 1 4 1 4 4 1 
4 4 4 4 4 4 4 4 4 4 4 4 4 4 4 4 4 4 1 1 5 5 4 4 4 4 4 4 4 4 4 4 4 4 4 4 4 4 4 4 4 4 4 4 4 4 4 4 4 4 4 4 4 4 5 13 1 4 1 1 4 4 12 12 12 12 12 12 12 12 4 4 4 4 1 1 1 4 4 1 
4 4 4 4 4 4 4 4 4 4 4 4 4 4 4 4 4 4 4 4 5 5 4 4 4 4 4 4 4 4 4 4 4 4 4 4 4 4 4 4 4 4 4 4 4 4 4 4 4 4 4 4 4 4 4 5 1 4 1 1 4 4 4 12 12 12 12 12 12 12 4 4 4 4 1 1 4 4 4 1 
4 4 4 4 4 4 4 4 4 4 4 4 4 4 4 4 4 4 4 4 4 4 4 4 4 4 4 4 4 4 4 4 4 4 4 4 4 4 4 4 4 4 4 4 4 4 4 4 4 4 4 4 4 4 1 5 1 4 1 1 4 4 4 4 12 12 12 12 12 12 4 4 4 4 1 1 4 4 4 1 
4 4 4 4 4 4 4 4 4 4 4 4 4 4 4 4 4 4 4 4 4 4 4 4 4 4 4 4 4 4 4 4 4 4 4 4 4 4 4 4 4 4 4 4 4 4 4 4 4 4 4 4 4 4 5 1 0 4 1 1 4 4 4 4 4 4 4 4 4 4 4 4 4 4 1 1 4 4 4 0 
4 4 4 4 4 5 5 4 4 4 4 4 4 4 4 4 4 4 4 4 4 4 4 4 4 4 4 4 4 4 4 4 4 4 4 4 4 4 4 4 4 4 4 4 4 4 4 4 4 4 4 4 4 1 5 13 4 1 1 1 4 4 4 4 4 4 4 4 4 4 4 4 4 4 4 1 1 4 4 0 
4 4 4 4 4 5 5 4 4 4 4 4 4 4 4 4 4 4 4 4 4 4 4 4 4 4 4 4 4 4 4 4 4 4 4 4 4 4 4 4 4 4 4 4 4 4 4 4 4 4 4 4 4 5 1 0 1 1 1 1 4 4 4 4 4 4 4 4 4 4 4 4 4 4 4 1 1 4 4 0 
4 4 4 4 4 4 4 4 4 4 4 4 4 4 4 4 4 4 4 4 4 4 4 4 4 4 4 4 4 4 4 4 4 4 4 4 4 4 4 4 4 4 4 4 4 4 4 4 4 4 4 4 5 5 13 1 1 1 1 4 4 4 4 4 4 4 4 4 4 4 4 4 4 4 4 4 4 1 1 1 
4 4 4 4 4 5 5 4 4 4 4 4 4 4 4 4 4 4 4 4 4 4 4 4 4 4 4 4 4 4 4 4 4 4 4 4 4 4 4 4 4 4 4 4 4 4 4 4 4 4 4 4 5 1 0 13 1 1 4 4 4 4 4 4 4 4 4 4 4 4 4 4 4 4 4 4 4 1 1 1 
4 4 4 4 1 5 1 4 4 4 4 4 4 4 4 4 4 4 4 4 4 4 4 4 4 4 4 4 4 4 4 4 4 4 4 4 4 4 4 4 4 4 4 4 4 4 4 4 4 4 4 4 5 13 1 1 5 4 4 4 4 4 4 4 4 4 4 1 1 4 4 4 4 4 4 1 1 4 4 0 
4 5 5 4 1 4 1 4 4 4 4 4 4 4 4 4 4 4 4 4 4 4 4 4 4 4 4 4 4 4 4 4 4 4 4 4 4 4 4 4 4 4 4 4 4 4 4 4 4 4 4 4 5 13 13 12 5 1 1 4 4 4 4 4 4 4 4 1 1 4 4 4 4 4 4 1 1 4 4 0 
4 5 5 1 5 4 1 4 5 5 4 4 4 4 4 4 4 4 4 4 4 4 4 4 4 4 4 4 4 4 4 4 4 4 4 4 4 4 4 4 4 4 4 4 4 4 4 4 4 4 4 4 5 1 1 1 5 1 1 4 4 4 4 4 4 4 1 1 4 1 1 4 4 4 4 4 1 1 4 0 
4 4 4 1 1 1 1 4 5 5 4 4 4 4 4 4 4 4 4 4 4 4 4 4 4 4 4 4 4 4 4 4 4 4 4 4 4 4 4 4 4 4 4 4 4 4 4 4 4 4 4 4 5 12 1 5 0 4 1 1 4 4 4 4 1 1 1 1 4 1 1 1 1 4 4 4 1 1 4 0 
4 4 4 1 1 1 1 4 4 4 4 4 4 4 4 4 4 4 4 4 4 4 4 4 4 4 4 4 4 4 4 4 4 4 4 4 4 4 4 4 4 4 4 4 4 4 4 4 4 4 4 4 5 12 5 4 4 4 1 1 1 1 1 1 1 1 4 4 4 4 4 1 1 1 1 1 1 1 4 1 
4 4 1 5 1 1 1 4 4 4 4 4 4 4 4 4 4 4 4 4 4 4 4 4 4 4 4 4 4 4 4 4 4 4 4 4 4 4 4 4 4 4 4 4 4 4 4 4 4 4 4 4 5 1 5 4 4 4 4 4 1 1 1 1 4 4 4 4 4 4 4 4 4 1 1 1 4 1 4 1 
4 4 1 4 1 1 5 1 4 4 4 4 4 4 4 4 4 4 4 4 4 4 4 4 4 4 4 4 4 4 4 4 4 4 4 4 4 4 4 4 4 4 4 4 4 4 4 4 4 4 4 4 5 5 4 4 4 4 4 4 4 4 4 4 4 4 4 4 4 4 4 4 4 4 1 5 4 1 4 1 
5 5 1 4 1 4 1 1 4 1 1 5 4 4 4 4 4 4 4 4 4 4 4 4 4 4 4 4 4 4 4 4 4 4 4 4 4 4 4 4 4 4 4 4 4 4 4 4 4 4 4 4 1 5 4 4 4 4 4 4 4 4 4 4 4 4 4 4 4 4 4 4 4 4 5 1 13 5 4 1 
1 1 1 4 1 4 1 1 4 1 12 5 4 4 4 4 4 4 4 4 4 4 4 4 4 4 4 4 4 4 4 4 4 4 4 4 4 4 4 4 4 4 4 4 4 4 4 4 4 4 4 4 5 5 4 4 4 4 4 4 4 4 4 4 12 12 12 12 12 4 4 4 4 4 5 13 13 5 1 1 
1 4 1 4 1 4 1 1 4 5 13 5 4 4 4 4 4 4 4 4 4 4 4 4 4 4 4 4 4 4 4 4 4 4 4 4 4 4 4 4 4 4 4 4 4 4 4 4 4 4 4 4 4 4 4 4 12 12 12 12 4 4 4 12 12 12 12 12 12 4 4 4 4 1 5 13 13 5 1 1 
1 4 1 1 1 4 1 1 4 4 4 4 4 4 4 4 4 4 4 4 4 4 4 4 4 4 4 4 4 4 4 4 4 4 4 4 4 4 4 4 4 4 4 4 4 4 5 5 1 1 4 4 4 4 4 12 12 12 12 12 12 12 12 12 12 12 12 12 12 12 4 4 4 5 4 13 13 5 1 1 
4 4 4 1 1 4 1 5 1 4 4 4 4 4 4 4 4 4 4 4 4 4 4 4 4 4 4 4 4 4 4 4 4 4 4 4 4 4 4 4 4 4 4 4 4 4 5 5 1 1 4 4 4 12 12 12 12 12 12 12 12 12 12 12 12 1 1 1 12 12 12 4 4 5 4 13 0 13 5 1 
4 4 4 1 1 1 1 4 1 4 4 4 4 4 4 4 4 4 4 4 4 4 4 4 4 4 4 4 4 4 4 4 4 4 4 4 4 4 4 4 4 4 4 4 1 1 4 4 4 4 4 4 12 12 12 12 1 1 1 1 12 12 12 12 12 1 1 1 1 12 12 4 4 5 4 13 4 13 5 1 
4 4 4 1 4 1 4 1 1 4 4 4 4 4 4 4 4 4 4 4 4 4 4 4 4 4 4 4 4 4 4 4 4 4 4 4 4 4 4 4 4 4 4 4 1 1 4 4 4 4 4 12 12 12 12 12 1 1 1 1 1 12 12 12 12 12 1 1 1 12 12 4 4 5 4 13 4 13 5 1 
4 4 4 1 4 1 4 1 5 1 4 4 5 5 4 4 4 4 4 4 4 4 4 4 4 4 4 4 4 4 4 4 4 4 4 4 4 4 4 4 4 4 4 4 1 1 1 4 4 4 4 12 12 12 12 12 1 1 1 1 1 1 12 12 12 12 12 12 12 12 12 4 4 5 1 0 4 13 5 1 
4 4 4 1 1 1 1 4 1 1 4 4 5 5 4 4 4 4 4 4 4 5 5 4 4 4 4 4 4 4 4 4 4 4 4 4 4 4 4 4 4 4 4 4 1 4 1 4 4 4 12 12 12 12 12 12 1 1 1 1 1 1 12 12 12 12 12 12 12 12 4 4 1 5 13 4 1 1 5 1 
4 4 4 4 1 1 1 4 1 5 1 4 4 4 4 4 4 4 4 4 4 5 5 4 4 4 4 4 4 4 4 4 4 4 4 4 4 4 4 4 4 4 4 1 5 4 1 4 4 4 12 12 12 12 12 12 1 1 1 1 1 1 12 12 12 12 12 4 4 4 4 4 5 4 13 4 13 1 5 1 
4 4 4 4 4 1 1 4 1 4 1 4 4 1 1 1 4 4 4 4 4 4 4 4 4 4 4 4 4 4 4 4 4 4 4 4 4 4 4 4 4 5 5 1 1 1 1 4 4 4 4 12 4 4 4 12 12 1 1 1 1 1 12 12 12 12 4 4 4 4 4 4 5 4 13 4 13 5 1 1 
4 4 4 4 4 1 1 4 4 1 1 4 4 1 4 1 4 4 4 4 4 1 1 1 4 4 4 4 4 4 4 4 4 4 4 4 4 4 4 4 4 5 5 1 1 1 1 4 4 4 4 4 4 4 4 4 12 12 12 12 12 12 12 12 12 4 4 4 4 4 4 1 5 1 0 4 13 5 1 1 
4 4 4 4 4 1 1 1 4 1 5 1 1 5 4 1 4 4 4 4 4 1 4 1 4 4 4 4 4 4 4 4 4 4 4 4 4 4 4 4 4 4 1 5 1 1 1 4 4 4 4 4 4 4 4 4 12 12 12 12 12 12 12 12 12 4 4 4 4 4 4 5 4 13 4 1 1 5 1 1 
4 4 4 1 4 1 1 1 4 1 4 1 1 1 1 1 4 4 4 4 1 5 4 1 4 4 4 4 4 4 4 4 4 4 4 4 4 4 4 4 4 4 1 4 1 1 5 1 4 4 4 4 4 4 4 4 12 1 1 1 1 12 12 4 4 4 4 4 1 1 1 5 1 0 4 13 1 5 1 1 
4 4 4 4 4 4 1 1 4 1 4 1 1 1 1 1 4 4 4 4 1 1 1 1 4 4 4 4 4 4 4 4 4 4 4 4 4 4 4 4 4 4 1 4 1 1 1 1 4 4 4 4 4 4 4 4 12 1 1 1 1 12 12 4 4 4 4 4 5 5 5 4 13 4 1 1 5 1 1 1 
4 4 4 4 4 4 5 1 13 13 4 5 5 13 13 5 4 4 4 4 1 1 1 1 4 4 4 4 4 4 4 4 4 4 4 4 4 4 4 4 4 4 1 4 1 4 1 1 4 4 4 4 4 4 4 4 12 12 1 1 1 12 12 4 4 4 4 4 4 4 5 4 13 1 1 1 5 1 1 1 
4 4 4 4 4 1 5 4 13 4 13 4 4 13 13 5 4 4 4 4 1 1 4 1 4 4 4 4 4 4 4 4 4 4 4 4 4 4 4 4 4 4 1 4 1 4 1 1 4 4 4 4 4 4 4 4 4 12 12 12 12 12 12 4 4 4 4 4 4 4 1 1 4 1 1 1 4 4 4 4 
4 4 4 4 4 1 5 13 1 13 4 13 4 13 13 5 5 4 4 4 4 1 4 1 4 4 4 4 4 4 4 4 4 4 4 4 4 4 4 4 4 4 1 4 1 4 1 1 4 4 4 4 4 4 4 4 4 4 4 12 12 12 12 4 4 4 4 4 4 4 1 13 1 1 1 4 4 4 4 4 
4 4 4 4 4 1 4 5 4 13 4 4 13 13 4 13 5 4 4 4 4 1 4 1 4 4 4 4 4 4 4 4 4 4 4 4 4 4 4 4 4 4 1 4 1 4 1 1 4 1 1 4 4 4 4 4 4 4 4 4 4 4 4 4 4 4 4 1 1 4 1 13 1 1 1 4 4 4 4 4 
1 4 4 4 4 1 1 5 13 13 4 4 4 4 4 13 5 4 4 4 4 1 1 1 4 4 4 4 4 4 4 4 4 4 4 4 4 4 4 4 4 4 1 1 1 4 1 1 4 5 5 4 4 4 4 4 4 4 4 4 4 4 4 4 4 4 4 5 5 4 1 1 1 1 4 4 4 4 4 4 
1 4 4 4 4 1 1 4 5 13 4 4 4 4 4 13 5 4 4 4 4 1 1 4 4 4 4 4 4 4 4 4 4 4 4 4 4 4 4 4 4 4 4 1 1 1 1 5 1 4 4 4 4 4 4 4 4 4 4 4 4 4 4 4 4 4 4 4 4 1 5 4 1 1 4 4 4 4 4 4 
4 4 4 4 4 4 4 4 5 1 1 13 4 4 4 13 5 5 4 4 4 4 4 4 4 4 4 4 4 4 4 4 4 4 4 4 4 4 4 4 4 5 5 1 4 1 1 1 5 5 1 4 4 4 4 4 4 1 1 4 4 4 4 4 4 1 5 1 1 5 4 4 1 4 4 4 4 4 4 4 
13 13 13 13 13 13 13 13 5 5 13 13 4 4 4 13 4 1 4 4 4 4 5 5 4 4 4 4 4 4 4 4 4 4 4 4 4 4 4 4 4 5 5 1 1 1 4 1 4 4 1 1 5 5 1 4 4 5 5 4 4 4 1 5 5 5 4 1 4 4 13 4 1 4 4 4 4 4 4 4 
