connections=[
		],
events={
	{
		exits:[ROUTE 114 (0.29),ROUTE 114 (0.29),		]},
	{
		NPCs:[
			{is_trainer:0,b1:1,b2:0,sprite:20},
		]},
	{
		signs:[
			{x:5,y:1},
			{x:8,y:1},
			{x:7,y:1},
		]},
	{
		triggers:[
		]},

},
[
	[1, 1, 1, 1, 1, 1, 1, 1, 1, 1, 1, ],
	[1, 1, 1, 1, 1, 1, 1, 1, 1, 1, 1, ],
	[1, 12, 1, 12, 12, 12, 12, 12, 12, 1, 12, ],
	[1, 1, 1, 12, 1, 12, 1, 1, 12, 1, 12, ],
	[1, 12, 12, 12, 1, 12, 1, 1, 12, 1, 1, ],
	[1, 1, 1, 12, 1, 12, 1, 1, 12, 12, 12, ],
	[1, 1, 1, 12, 12, 12, 12, 12, 12, 1, 1, ],
	[1, 1, 1, 12, 12, 0, 0, 1, 1, 1, 1, ],
]
