Connections;
Exits;SAFARI ZONE (26.3);SAFARI ZONE (26.3);ROUTE 121 (0.36);ROUTE 121 (0.36);
1 1 1 1 1 1 1 1 1 1 1 1 1 1 1 1 1 1 
1 1 1 1 1 1 1 1 1 1 1 1 1 1 1 1 1 1 
12 12 12 12 12 12 1 12 12 12 12 1 12 12 12 12 12 12 
12 12 12 12 12 12 1 1 1 1 1 1 12 12 12 12 12 12 
12 12 12 12 12 12 12 12 12 12 12 12 12 12 12 12 12 12 
13 12 0 0 12 12 12 1 1 1 1 12 12 12 12 12 12 12 
1 1 1 1 1 1 1 1 1 1 1 1 12 12 12 12 12 12 
1 1 1 1 1 1 1 1 1 1 1 1 12 12 12 12 1 1 
1 1 1 1 1 1 1 1 1 1 1 1 1 12 12 12 1 12 
1 1 1 1 1 1 1 1 1 1 1 1 12 12 12 12 1 12 
1 1 1 1 1 1 1 1 1 1 1 1 12 12 12 12 1 12 
1 1 1 1 1 1 1 1 1 1 1 1 12 12 12 12 1 1 
1 1 1 1 1 1 1 1 1 1 1 1 12 12 12 12 12 12 
1 1 1 1 1 1 1 1 1 1 1 1 13 12 0 0 12 13 
