Connections;left:ROUTE 115 (0.30);right:FALLARBOR TOWN (0.13);
Exits;METEOR FALLS (24.0);ROUTE 114 (20.0);ROUTE 114 (20.2);TERRA CAVE (24.104);TERRA CAVE (24.104);
1 1 1 1 1 1 1 1 1 1 1 1 1 1 1 0 1 0 0 1 1 0 1 1 1 0 0 0 0 0 0 0 0 0 0 0 0 0 0 0 
1 1 1 1 1 1 1 1 1 1 1 1 1 1 1 1 0 1 1 1 1 0 1 1 0 1 1 1 1 1 1 1 1 1 1 1 1 1 1 1 
1 1 1 1 1 0 0 0 0 0 0 0 0 0 0 0 0 1 1 1 1 12 12 12 12 1 1 1 1 1 1 1 1 1 1 1 1 1 1 1 
1 1 1 1 12 1 1 1 1 1 1 1 1 1 1 1 1 1 1 12 1 1 1 1 1 1 1 1 1 1 1 1 1 1 1 1 1 1 1 1 
1 1 1 0 12 1 1 1 1 1 1 1 1 1 1 1 1 1 1 1 1 1 1 1 1 1 1 1 1 1 1 1 1 13 1 13 1 13 1 13 
1 1 1 1 12 1 1 12 12 4 4 4 4 4 4 4 4 4 4 1 1 1 1 1 1 1 1 1 1 1 1 1 12 12 12 12 12 12 12 12 
1 1 1 1 12 1 1 12 12 4 4 4 4 4 4 4 4 4 4 1 1 1 1 12 12 12 12 12 12 12 12 12 12 12 12 12 12 12 12 12 
12 12 12 12 12 1 1 12 12 4 4 4 4 4 4 1 1 1 1 1 1 1 12 12 4 4 4 4 12 12 12 1 12 12 12 12 12 12 12 12 
1 1 1 1 1 1 1 12 12 4 4 4 4 1 1 1 1 1 1 1 1 1 12 12 4 4 4 4 12 12 12 12 12 12 12 12 12 12 12 12 
1 1 1 1 1 1 1 12 12 4 4 4 4 1 1 1 1 1 1 1 1 1 12 12 4 4 4 4 12 12 12 12 12 12 12 12 12 12 12 12 
1 1 1 1 1 1 1 1 1 4 4 4 4 1 1 1 1 1 12 12 12 12 12 12 12 12 12 12 12 12 12 12 12 12 12 12 12 12 12 12 
1 1 1 1 1 1 1 1 1 4 4 4 4 1 1 1 12 12 12 12 12 12 12 12 12 12 12 12 12 12 12 12 12 12 12 12 12 12 12 12 
1 1 1 1 1 1 1 1 1 4 4 4 4 1 1 1 12 1 1 12 12 12 12 12 12 12 12 12 12 12 12 12 12 12 12 12 12 12 12 12 
1 1 12 1 1 1 1 12 12 4 4 4 4 12 12 12 12 4 4 4 12 12 12 12 12 12 12 12 12 12 12 12 12 12 12 12 12 12 12 12 
1 1 12 1 1 1 1 1 12 4 4 4 4 12 1 1 12 4 4 4 12 12 12 4 4 4 4 4 12 12 12 12 12 12 12 12 12 12 12 12 
1 1 12 1 1 1 1 12 4 4 4 4 4 1 1 1 1 4 4 4 12 12 12 4 4 4 4 4 1 1 12 12 12 12 12 12 12 12 12 12 
4 4 4 4 4 1 1 4 4 4 4 4 4 12 12 12 12 12 12 12 12 12 12 4 4 4 4 4 12 1 1 12 12 12 12 12 12 1 1 12 
4 1 1 4 4 1 1 1 1 4 4 4 4 4 4 4 12 12 12 12 12 12 12 4 4 4 4 4 12 12 1 1 1 1 12 12 1 1 1 1 
4 1 1 4 4 4 4 1 1 4 4 4 4 4 4 4 12 1 1 12 12 12 12 4 4 4 4 4 12 1 1 1 1 1 1 1 1 12 12 1 
12 12 12 1 1 1 1 12 4 4 4 4 4 4 4 4 1 1 1 1 12 12 12 12 12 12 12 12 12 12 12 12 1 1 1 1 1 1 1 1 
1 1 1 1 1 1 1 1 4 4 4 4 4 4 4 4 12 1 1 12 12 12 12 12 12 12 12 1 12 1 1 12 12 1 1 1 1 1 1 1 
1 1 1 1 1 1 1 12 4 4 4 4 4 4 4 4 4 4 4 12 12 12 12 4 4 4 4 4 4 4 1 1 1 1 1 1 1 1 1 1 
1 1 1 1 1 1 1 1 4 4 4 4 4 4 4 4 4 4 4 12 12 12 12 4 4 4 4 4 4 4 12 1 1 1 1 12 12 1 1 1 
1 1 1 1 1 1 1 4 4 4 4 4 4 4 4 4 4 4 4 12 12 12 12 4 4 4 4 4 4 4 1 1 1 1 1 1 1 1 1 1 
1 1 1 1 1 1 1 4 4 4 4 4 4 4 4 4 4 4 4 12 12 12 12 4 4 4 4 4 4 4 12 1 1 12 12 1 1 1 1 1 
1 1 1 1 1 1 1 4 4 4 12 12 12 12 4 4 4 4 4 12 12 12 12 4 4 4 4 4 4 4 1 1 1 1 1 1 1 1 1 1 
1 1 1 1 1 1 1 4 4 4 12 12 12 12 4 4 4 4 4 12 12 12 12 4 4 4 4 4 4 4 4 4 4 1 1 1 1 1 1 1 
1 1 1 1 1 1 1 4 4 4 12 13 13 12 4 4 4 4 4 12 12 12 12 4 4 4 4 4 4 4 4 4 4 1 1 1 1 1 1 1 
1 1 1 1 1 1 1 4 4 4 12 12 12 12 4 4 4 4 4 12 12 12 12 4 4 4 4 4 4 4 4 4 4 1 1 1 1 1 1 1 
1 1 1 1 1 1 1 4 4 4 4 4 4 4 4 4 4 4 4 12 12 12 12 4 4 4 4 4 4 4 4 4 4 1 1 1 1 1 1 1 
1 1 1 1 1 1 1 12 4 4 4 4 4 4 4 4 4 4 4 12 12 12 12 4 4 4 4 4 4 4 4 4 4 1 1 1 1 1 1 1 
1 1 1 1 1 1 1 12 4 4 4 4 4 4 4 4 4 4 4 12 12 12 12 4 4 4 4 4 4 4 4 4 4 1 1 1 1 1 1 1 
1 1 1 1 1 1 1 12 4 4 4 4 4 4 4 4 4 4 4 12 12 12 12 4 4 4 4 4 4 4 4 4 4 1 1 1 1 1 1 1 
1 1 1 1 1 1 1 12 12 12 12 12 12 12 4 4 4 4 4 12 12 12 12 4 12 12 12 12 12 12 12 12 12 1 1 1 1 1 1 1 
1 1 1 1 1 1 1 1 1 1 1 1 12 12 12 12 12 12 12 12 12 12 12 12 12 1 1 1 1 1 12 12 12 1 1 1 1 1 1 1 
1 1 1 1 1 1 1 1 1 1 1 1 12 12 12 12 12 12 12 12 12 12 12 12 12 1 1 1 1 1 12 12 12 1 1 1 1 1 1 1 
1 1 1 1 1 1 1 1 1 1 1 16 16 1 1 1 1 1 1 12 12 12 1 1 1 1 1 1 1 1 12 12 12 1 1 1 1 1 1 1 
1 1 1 1 1 1 1 1 1 1 1 16 16 1 1 12 12 12 12 12 12 12 12 12 1 1 12 12 12 1 1 12 12 1 1 1 1 1 1 1 
1 1 1 1 1 1 1 1 1 1 1 1 16 1 1 12 12 12 12 12 12 12 1 1 12 1 12 12 12 12 1 12 12 1 1 1 1 1 1 1 
1 1 1 1 1 1 1 1 1 1 1 1 16 1 1 12 12 12 12 12 12 12 1 1 12 12 12 12 12 12 1 12 12 1 1 1 1 1 1 1 
1 1 1 1 1 1 1 1 1 1 1 1 16 1 1 12 12 12 12 12 12 12 12 1 1 12 12 12 12 12 1 12 12 1 1 1 1 1 1 1 
1 1 1 1 1 1 1 1 1 1 1 1 16 1 1 12 12 1 1 1 1 12 12 1 1 12 12 12 12 12 1 12 12 1 1 1 1 1 1 1 
1 1 1 1 1 1 1 1 1 1 1 1 16 1 1 13 12 1 12 12 12 12 12 12 12 12 12 12 12 12 1 12 12 1 1 1 1 1 1 1 
1 1 1 1 1 1 1 1 1 1 1 1 16 1 1 12 12 1 12 12 12 12 12 12 12 12 12 12 12 12 1 13 12 1 1 1 1 1 1 1 
1 1 1 1 1 1 1 1 1 1 1 1 16 16 16 1 12 1 12 12 12 12 12 12 12 12 12 1 1 12 1 13 12 1 1 1 1 1 1 1 
1 1 1 1 1 1 1 1 1 1 1 1 16 16 16 16 1 1 12 12 12 12 12 12 12 12 12 12 1 12 1 13 12 1 1 1 1 1 1 1 
1 1 1 1 1 1 1 1 1 1 1 1 16 16 16 16 1 1 12 12 12 1 1 1 1 1 1 12 1 12 1 12 12 1 1 1 1 1 1 1 
1 1 1 1 1 1 16 16 1 1 1 16 16 16 16 16 1 1 12 12 12 12 12 12 12 12 1 12 1 1 1 1 1 1 1 1 1 1 1 1 
1 1 1 1 1 16 16 1 1 16 16 16 16 16 16 16 1 1 12 12 12 12 12 12 12 12 1 12 1 1 1 1 1 1 1 1 1 1 1 1 
1 1 1 1 1 1 0 1 16 16 16 16 16 1 0 0 1 12 12 12 1 1 12 12 12 12 1 1 1 1 1 1 1 1 1 1 1 1 1 1 
1 1 1 1 1 1 16 16 16 16 16 16 16 1 12 12 12 12 12 12 1 1 12 12 12 12 1 1 1 1 1 1 1 1 1 1 1 1 1 1 
1 1 1 1 1 1 16 16 16 16 16 16 16 1 12 12 12 12 12 12 12 12 12 12 12 12 1 1 1 1 1 1 1 1 1 25 1 1 1 1 
1 1 1 1 1 1 16 1 1 16 16 16 16 1 12 12 12 12 12 12 12 12 12 12 12 12 1 1 1 20 20 1 1 1 1 1 1 1 1 1 
1 1 1 1 1 1 1 1 1 16 16 16 16 16 16 16 1 12 12 12 12 12 12 1 1 1 1 1 1 20 20 1 1 1 1 1 1 1 1 1 
1 1 1 1 1 1 1 1 1 1 16 16 16 16 16 16 1 12 12 12 12 12 12 1 1 20 20 20 20 20 20 1 1 1 1 1 1 1 1 1 
1 1 1 1 1 1 1 1 1 1 1 1 16 16 16 16 16 16 1 12 12 12 12 1 1 20 20 20 20 20 20 1 1 1 1 1 1 1 1 1 
1 1 1 1 1 1 1 1 1 1 1 1 1 1 16 16 16 16 1 12 12 12 12 1 1 20 20 20 20 20 20 1 1 1 1 1 1 1 1 1 
1 1 1 1 1 1 1 1 1 1 1 1 1 1 16 16 16 16 1 12 13 12 12 1 1 0 0 1 20 20 20 1 1 1 1 1 1 1 1 1 
1 1 1 1 1 1 1 1 1 1 1 1 1 1 16 16 16 16 16 16 16 16 16 16 16 16 16 1 20 20 20 20 20 1 1 1 1 1 1 1 
1 1 1 1 1 1 1 1 1 1 1 1 1 1 16 16 16 16 16 16 16 16 16 16 16 16 16 1 20 20 20 20 20 1 1 1 1 1 1 1 
1 1 1 1 1 1 1 1 1 1 1 1 1 1 16 16 16 16 16 16 16 16 16 16 16 16 16 1 20 20 20 20 20 1 1 1 1 1 1 1 
1 1 1 1 1 1 1 1 1 1 1 1 1 1 1 1 1 1 1 1 1 1 16 16 16 16 1 20 20 20 20 20 1 1 1 1 1 1 1 1 
1 1 1 1 1 1 1 1 1 1 1 1 1 1 1 28 28 28 28 28 1 1 1 1 1 1 1 1 20 20 20 20 1 1 1 1 1 1 1 1 
1 1 1 1 1 1 1 1 0 1 1 20 1 1 1 28 28 28 28 28 28 28 28 28 1 1 1 1 20 20 20 20 1 1 1 1 1 1 1 1 
1 1 1 1 1 1 1 1 20 20 20 20 1 28 28 28 28 28 28 28 28 28 28 28 1 1 1 1 20 20 20 1 1 1 1 1 1 1 1 1 
1 1 1 1 1 1 1 20 20 20 20 1 1 28 28 28 28 28 28 28 28 28 28 28 28 28 1 20 20 20 20 1 1 1 1 1 1 1 1 1 
1 1 1 1 1 1 1 20 20 20 20 1 1 28 28 28 28 28 1 1 1 1 28 28 28 28 1 1 20 20 20 1 1 1 1 1 1 1 1 1 
1 1 1 1 1 1 1 1 20 20 20 1 1 28 28 1 1 1 1 1 1 1 28 28 28 28 1 1 20 20 20 1 1 1 1 1 1 1 1 1 
1 1 1 1 1 1 1 1 20 20 20 1 1 28 28 28 1 1 1 1 1 1 28 28 28 28 1 1 20 20 20 1 1 1 1 1 1 1 1 1 
1 1 1 1 1 1 1 20 20 20 20 20 1 0 0 1 1 1 1 1 1 28 28 1 28 28 1 1 20 20 20 1 1 1 1 1 1 1 1 1 
1 1 1 1 1 1 1 1 20 20 20 20 20 20 20 1 1 1 1 1 1 28 1 1 28 28 28 1 20 20 20 1 1 1 1 1 1 1 1 1 
1 1 1 1 1 1 1 1 20 20 20 20 20 20 20 1 1 1 28 28 28 28 1 1 0 0 1 1 20 20 20 1 1 1 1 1 1 1 1 1 
1 1 1 1 1 1 1 1 1 20 20 20 20 20 20 1 1 1 1 1 1 1 1 1 20 20 20 20 20 20 20 1 1 1 1 1 1 1 1 1 
1 1 1 1 1 1 1 1 1 1 20 20 20 20 20 1 1 1 1 1 1 1 1 1 20 20 20 20 20 20 1 1 1 1 1 1 1 1 1 1 
1 1 1 1 1 1 1 1 1 1 1 1 1 1 1 1 1 1 1 1 1 1 1 1 1 20 20 20 20 1 1 1 1 1 1 1 1 1 1 1 
1 1 1 1 1 1 1 1 1 1 1 1 1 1 1 1 1 1 1 1 1 1 1 1 1 1 1 1 1 1 1 1 1 1 1 1 1 1 1 1 
1 1 1 1 1 1 1 1 1 1 1 1 1 1 1 1 1 1 1 1 1 1 1 1 1 1 1 1 1 1 1 1 1 1 1 1 1 1 1 1 
1 1 1 1 1 1 1 1 1 1 1 1 1 1 1 1 1 1 1 1 1 1 1 1 1 1 1 1 1 1 1 1 1 1 1 1 1 1 1 1 
1 1 1 1 1 1 1 1 1 1 1 1 1 1 1 1 1 1 1 1 1 1 1 1 1 1 1 1 1 1 1 1 1 1 1 1 1 1 1 1 
1 1 1 1 1 1 1 1 1 1 1 1 1 1 1 1 1 1 1 1 1 1 1 1 1 1 1 1 1 1 1 1 1 1 1 1 1 1 1 1 
