Connections;
Exits;ROUTE 119 (0.34);ROUTE 119 (0.34);ROUTE 119 (32.1);
1 1 1 1 1 1 1 1 1 1 1 1 1 1 1 1 1 1 1 1 
1 1 1 1 1 1 1 1 1 1 1 1 1 1 1 1 1 0 1 1 
1 1 12 1 12 12 12 1 1 1 1 1 12 12 12 12 12 12 12 1 
1 1 12 1 12 12 12 1 12 12 12 12 12 12 12 12 12 12 12 12 
12 12 12 1 12 12 12 1 12 12 12 1 1 12 12 12 1 1 12 12 
12 12 12 1 12 12 12 1 12 12 12 1 1 12 12 12 1 1 12 12 
12 12 12 12 12 12 12 12 12 12 12 1 1 12 12 12 1 1 12 12 
12 1 12 12 12 12 12 12 12 12 12 12 12 12 12 12 12 12 12 1 
1 1 1 1 12 12 12 1 1 1 1 1 1 1 1 1 1 1 1 1 
1 1 1 1 12 12 12 1 1 1 1 1 1 1 1 1 1 1 1 1 
12 12 12 12 12 12 12 12 12 12 12 12 12 12 12 12 12 12 12 12 
12 12 12 12 12 12 12 12 12 12 12 12 12 12 12 12 12 12 12 12 
12 12 12 12 12 12 12 12 1 0 0 1 12 12 12 12 12 12 12 12 
