Connections;
Exits;ROUTE 124 (0.39);ROUTE 124 (0.39);
1 1 1 1 1 1 1 1 1 1 
1 1 1 1 1 1 1 1 1 12 
12 12 12 12 12 12 12 12 12 1 
12 12 12 12 12 12 12 12 12 12 
12 0 12 13 13 0 0 0 12 12 
12 0 12 13 13 0 0 0 12 12 
12 12 12 12 12 12 12 0 12 12 
12 12 12 12 12 12 12 12 12 12 
12 12 12 0 0 12 12 12 12 13 
