Connections;up:RUSTBORO CITY (0.3);down:ROUTE 105 (0.20);right:PETALBURG CITY (0.0);
Exits;ROUTE 104 (17.0);ROUTE 104 (17.1);PETALBURG WOODS (24.11);PETALBURG WOODS (24.11);PETALBURG WOODS (24.11);PETALBURG WOODS (24.11);PETALBURG WOODS (24.11);PETALBURG WOODS (24.11);
1 13 1 13 1 13 1 13 1 1 12 12 12 12 12 12 12 12 12 12 12 12 12 12 12 12 12 12 12 12 12 12 12 12 1 1 1 1 1 1 
1 1 1 1 1 1 1 1 1 1 1 1 12 12 12 12 12 12 12 12 12 12 12 12 12 12 12 12 12 12 12 12 12 12 1 1 1 1 1 1 
1 13 1 13 1 13 1 13 1 13 1 1 12 12 12 12 12 12 12 12 12 12 12 12 12 12 12 12 12 12 12 12 1 1 1 1 1 1 1 1 
1 1 1 1 1 1 1 1 1 1 1 1 1 1 12 12 12 12 12 12 12 12 12 12 12 12 12 12 12 12 12 12 1 1 1 1 1 1 1 1 
1 13 1 13 1 13 12 12 1 13 1 1 1 1 12 12 12 12 12 12 12 12 12 12 12 12 12 12 12 12 12 12 1 1 1 1 1 1 1 1 
1 1 1 1 1 1 12 12 13 1 1 1 1 1 12 12 12 12 12 12 12 12 12 1 12 12 12 12 12 12 12 12 1 1 1 1 1 1 1 1 
1 13 12 12 12 12 12 12 12 12 1 1 1 1 12 12 12 12 12 12 12 12 12 12 12 12 12 12 12 12 12 12 12 12 13 13 13 12 1 1 
1 1 12 12 12 12 12 12 12 12 1 13 1 1 1 1 12 12 12 12 12 12 12 12 12 12 12 12 12 12 12 12 12 12 12 12 12 12 1 1 
1 13 12 12 12 12 12 12 12 12 1 1 1 1 1 1 1 1 1 1 12 12 12 12 12 12 12 12 12 12 12 12 12 12 12 12 12 12 1 1 
1 1 12 12 12 12 12 12 1 1 1 1 1 1 1 1 1 1 1 1 4 4 4 4 12 12 4 4 4 4 4 4 4 4 4 4 4 4 1 1 
1 1 12 12 12 12 1 1 1 1 1 1 1 1 1 1 1 1 1 1 4 4 4 4 12 12 4 4 4 4 4 4 4 4 4 4 4 4 1 1 
1 1 12 12 12 12 1 1 1 1 1 1 1 1 1 1 1 1 1 1 4 4 4 4 12 12 4 4 4 4 4 4 4 4 4 4 4 4 1 1 
1 1 12 12 1 1 1 1 1 1 1 1 1 1 1 1 4 4 4 4 4 4 4 4 12 12 4 4 4 4 4 4 4 4 4 4 4 4 1 1 
1 1 12 12 1 1 1 1 1 1 1 1 1 1 4 4 4 4 4 4 4 4 4 4 12 12 4 4 4 4 4 4 4 4 4 4 4 4 1 1 
1 1 12 12 1 1 1 1 1 1 1 1 1 1 4 4 4 4 4 4 4 4 4 4 12 12 4 4 4 4 4 4 4 4 4 4 4 4 1 1 
1 1 12 12 1 1 1 1 1 1 1 1 1 4 4 4 4 4 4 4 4 4 4 4 12 12 12 12 12 12 12 12 4 4 4 4 4 4 12 12 
1 1 12 1 1 1 1 1 1 1 1 1 1 4 4 4 4 4 4 4 4 4 4 4 12 12 12 12 12 12 12 12 4 4 4 4 4 4 12 12 
1 1 12 1 1 1 1 1 1 1 1 1 1 4 4 4 4 4 4 4 4 4 4 4 4 4 4 4 4 4 12 12 4 4 4 4 4 4 1 1 
1 1 12 1 1 0 1 1 1 1 1 1 1 4 4 4 4 4 4 4 4 4 4 4 4 4 4 4 4 4 12 12 4 4 4 4 4 4 1 1 
1 1 12 12 12 12 12 12 12 12 12 1 1 4 4 4 4 4 4 4 4 4 4 4 4 4 4 4 4 4 12 12 4 4 4 4 4 4 1 1 
1 1 12 12 12 12 12 1 12 12 12 13 13 4 4 4 4 4 4 4 4 4 4 4 4 4 4 4 4 4 12 12 4 4 4 4 4 4 1 1 
1 13 12 12 12 12 12 12 12 12 12 12 12 4 4 4 4 4 4 4 4 4 4 4 4 4 4 4 4 4 12 12 4 4 4 4 4 4 1 1 
13 13 12 13 12 12 12 12 12 12 12 12 12 12 12 12 12 12 12 12 12 12 12 12 12 12 12 12 12 12 12 12 12 12 12 12 12 12 1 1 
13 13 12 13 12 12 12 12 12 12 12 12 12 12 12 12 12 13 12 12 12 12 12 12 12 12 12 12 12 12 12 12 12 12 1 1 1 1 1 1 
1 13 12 13 12 12 12 12 12 12 12 12 12 12 12 12 12 12 12 12 12 12 12 12 12 12 12 12 12 12 12 12 12 12 1 1 1 1 1 1 
1 1 12 13 12 12 12 12 12 12 12 12 12 12 12 12 12 12 12 12 12 12 12 12 12 12 12 12 12 12 12 12 1 1 1 1 1 1 1 1 
1 1 12 12 12 12 12 12 12 12 12 12 12 12 12 12 12 12 12 12 12 12 12 12 12 12 12 12 12 12 12 12 1 1 1 1 1 1 1 1 
1 1 12 12 12 12 12 12 12 12 12 12 12 12 13 13 13 13 13 13 13 13 13 13 13 13 13 13 13 13 13 13 1 1 1 1 1 1 1 1 
1 1 1 13 1 13 13 13 13 13 12 12 13 13 12 12 12 1 1 12 12 12 12 1 1 1 12 12 12 12 1 1 1 1 1 1 1 1 1 1 
1 1 1 1 1 1 1 1 12 12 12 12 12 12 1 1 1 1 1 1 1 1 1 1 1 1 1 1 1 1 1 1 1 1 1 1 1 1 1 1 
1 13 1 1 1 1 1 1 1 1 12 12 1 1 1 1 1 1 1 1 1 1 1 1 1 1 1 1 1 1 1 1 1 1 1 1 1 1 1 1 
1 1 1 1 1 1 1 1 1 1 1 1 1 1 1 1 1 1 1 1 1 1 1 1 1 1 1 1 1 1 1 1 1 1 1 1 1 1 1 1 
1 1 1 1 1 1 1 1 1 1 1 1 1 1 1 1 1 1 1 1 1 1 1 1 1 1 1 1 1 1 1 1 1 1 1 1 1 1 1 1 
1 1 1 1 1 1 1 1 1 1 1 1 1 1 1 1 1 1 1 1 1 1 1 1 1 1 1 1 1 1 1 1 1 1 1 1 1 1 1 1 
1 1 1 1 1 1 1 1 1 1 1 1 1 1 1 1 1 1 1 1 1 1 1 1 1 1 1 1 1 1 1 1 1 1 1 1 1 1 1 1 
1 1 1 1 1 1 1 1 1 1 1 1 1 1 1 1 1 1 1 1 1 1 1 1 1 1 1 1 1 1 1 1 1 1 1 1 1 1 1 1 
1 1 1 1 1 1 1 1 1 1 1 1 1 1 1 1 1 1 1 1 1 1 1 1 1 1 1 1 1 1 1 1 1 1 1 1 1 1 1 1 
1 1 1 1 1 1 1 1 1 1 1 1 1 1 1 1 1 1 1 1 1 1 1 1 1 1 1 1 1 1 1 1 1 1 1 1 1 1 1 1 
1 1 1 1 1 1 1 1 1 1 12 12 1 1 1 1 1 1 1 1 1 1 1 1 1 1 1 1 1 1 1 1 1 1 1 1 1 1 1 1 
4 4 4 4 1 1 1 1 1 1 12 12 1 1 1 1 1 1 1 1 1 1 1 1 1 1 1 1 1 1 1 1 1 1 1 1 1 1 1 1 
4 4 4 4 1 1 1 1 13 1 12 12 13 13 1 1 1 1 1 1 1 1 1 1 1 1 1 1 1 1 1 1 1 1 1 1 1 1 1 1 
4 4 4 4 4 1 1 12 12 12 12 12 12 12 12 12 1 1 1 1 1 12 13 13 13 12 1 1 1 1 1 1 1 1 1 1 1 1 1 1 
4 4 4 4 4 4 1 12 12 12 12 12 12 12 12 12 12 12 12 12 12 12 12 12 12 12 1 1 1 1 1 1 12 12 1 1 1 1 1 1 
4 4 4 4 4 4 1 12 12 12 12 12 12 12 12 12 12 12 12 12 12 12 12 12 12 12 1 1 1 1 1 1 12 12 1 1 1 1 1 1 
4 4 4 4 4 4 1 1 12 12 12 12 12 12 12 12 12 12 12 12 12 12 12 12 12 12 1 1 1 1 1 12 12 12 1 1 1 1 1 1 
4 4 4 4 4 4 4 1 12 12 12 12 12 12 12 12 12 12 12 12 12 12 12 12 12 12 1 1 1 1 1 12 12 12 1 1 1 1 1 1 
4 4 4 4 4 4 4 1 1 1 1 12 12 12 12 12 12 12 12 12 12 12 12 12 12 12 1 1 1 1 1 12 12 12 1 1 1 1 1 1 
4 4 4 4 4 4 4 4 5 5 1 1 1 1 1 12 12 12 12 12 12 12 12 12 12 12 12 1 1 1 12 12 12 12 1 1 1 1 1 1 
4 4 4 4 4 4 4 1 1 5 5 5 5 5 1 13 1 1 1 1 12 12 12 12 12 12 12 1 1 1 12 12 12 12 1 1 1 1 1 1 
4 4 4 4 4 4 4 1 1 5 5 5 5 5 1 13 1 1 1 1 12 12 12 12 12 12 12 12 1 12 12 12 12 12 13 13 1 1 1 1 
4 4 4 4 4 4 4 4 5 1 1 5 5 5 1 13 1 0 1 1 1 12 12 12 12 12 12 12 1 12 12 12 12 12 1 1 1 1 1 1 
4 4 4 4 4 4 4 1 1 1 1 1 16 16 16 0 12 12 12 12 12 12 12 12 12 12 12 12 1 12 12 12 12 12 1 1 1 1 1 1 
4 4 4 4 4 1 1 1 1 4 4 1 16 16 16 0 12 12 12 12 12 12 12 12 12 12 12 12 1 12 12 12 12 12 1 1 1 1 1 1 
4 4 4 4 4 1 1 4 4 4 4 4 4 4 1 12 12 12 12 12 12 12 12 12 12 12 12 12 1 12 12 12 1 1 13 13 1 1 1 1 
4 4 4 4 5 5 1 4 4 4 4 4 4 4 1 1 12 12 1 1 12 12 12 12 12 12 12 12 1 12 12 12 13 13 1 1 1 1 1 1 
4 4 4 4 5 4 1 4 4 4 4 4 4 4 12 12 12 12 12 1 12 12 12 12 12 12 12 12 1 1 1 12 1 1 13 13 1 1 1 1 
4 4 4 4 5 1 1 4 4 4 4 4 4 4 4 12 12 12 12 1 12 12 12 12 12 12 12 12 12 12 1 12 13 13 1 1 1 1 1 1 
4 4 4 4 4 1 1 4 4 4 4 4 4 4 4 12 12 12 12 1 12 12 12 12 12 12 12 12 12 12 1 1 1 1 13 13 1 1 1 1 
4 4 4 4 4 1 1 4 4 4 4 4 4 4 4 12 12 12 12 1 1 12 12 12 12 12 12 12 12 12 12 12 12 12 1 1 1 1 1 1 
4 4 4 4 4 4 1 1 4 4 4 4 4 4 4 12 12 12 12 12 1 12 12 12 12 12 12 12 12 12 12 12 12 12 13 13 1 1 1 1 
4 4 4 4 4 4 1 1 4 4 4 4 4 4 4 12 12 12 12 12 1 1 12 12 12 12 12 12 12 12 12 12 12 12 12 12 13 13 13 1 
4 4 4 4 4 4 1 1 4 4 4 4 4 4 12 12 12 12 12 12 12 1 12 12 12 12 12 12 12 12 12 12 12 12 12 12 12 12 12 12 
4 4 4 4 4 4 1 1 4 4 4 4 4 4 12 12 12 12 12 12 12 1 1 1 12 12 12 12 12 12 12 12 12 12 12 12 12 12 12 12 
4 4 4 4 4 4 4 1 1 4 4 4 4 4 12 12 12 12 12 12 12 12 12 1 12 12 12 12 12 12 12 12 12 12 12 12 12 12 12 12 
4 4 4 4 4 1 1 1 1 4 4 4 4 4 12 12 12 12 12 12 12 12 12 1 1 12 12 12 12 12 12 12 12 12 12 12 1 1 1 1 
4 4 4 4 4 1 1 4 4 4 4 4 4 4 12 12 12 12 12 12 12 12 12 12 1 12 12 12 12 12 12 12 12 12 12 12 1 1 1 1 
4 4 4 4 4 4 1 1 4 4 4 4 4 4 4 12 12 12 12 12 12 12 12 12 1 1 1 1 12 12 12 12 12 12 1 13 1 13 13 13 
4 4 4 4 4 4 1 1 4 4 4 4 4 4 4 12 12 12 12 12 12 12 12 12 12 12 1 12 12 12 12 12 12 12 1 1 1 1 1 1 
4 4 4 4 5 5 1 4 4 4 4 4 4 4 4 12 12 12 12 12 12 12 12 12 12 12 1 12 12 12 12 12 1 1 1 1 1 1 1 1 
4 4 4 4 5 4 1 4 4 4 4 4 4 4 4 12 12 12 12 12 12 12 12 12 12 12 1 12 12 12 12 12 1 1 1 1 1 13 1 1 
4 4 4 4 5 1 1 4 4 4 4 4 4 4 4 4 12 12 12 12 12 12 12 12 12 12 1 1 12 12 1 1 1 1 1 1 1 1 1 1 
4 4 4 4 4 4 4 1 1 4 4 4 4 4 4 4 12 12 12 12 12 12 12 12 12 12 12 12 12 12 12 1 1 13 1 13 1 1 1 1 
4 4 4 4 4 4 4 1 1 4 4 4 4 4 4 4 12 12 12 12 12 12 12 12 12 12 12 12 12 12 12 1 1 1 1 1 1 1 1 1 
4 4 4 4 4 4 1 1 4 4 4 4 4 4 4 4 4 4 12 12 12 12 12 12 12 12 12 12 12 12 12 1 13 1 13 1 1 1 13 1 
4 4 4 4 4 4 1 1 4 4 4 4 4 4 4 4 4 4 4 4 12 12 12 12 12 12 12 12 12 12 12 1 1 1 1 1 1 1 1 1 
4 4 4 4 4 1 1 4 4 4 4 4 4 4 4 4 4 4 4 4 4 4 4 12 12 12 12 12 12 12 12 1 1 13 1 13 13 1 1 1 
4 4 4 4 4 1 1 1 1 4 4 4 4 4 4 4 4 4 4 4 4 4 4 4 4 4 4 4 4 12 12 1 13 1 13 1 1 1 1 1 
4 4 4 4 4 4 4 1 1 4 4 4 4 4 4 4 4 4 4 4 4 4 4 4 4 4 4 4 4 1 1 1 1 1 1 1 1 1 1 1 
4 4 4 4 4 4 1 1 4 4 4 4 4 4 4 4 4 4 4 4 4 4 4 4 4 4 4 1 1 1 1 1 1 1 1 1 13 1 13 1 
4 4 4 4 4 4 1 1 4 4 4 4 4 4 4 4 4 4 4 4 4 4 4 4 4 4 4 1 1 4 4 1 1 1 1 1 1 1 1 1 
