connections=[
		],
events={
	{
		exits:[ROUTE 119 (0.34),ROUTE 119 (0.34),ROUTE 119 (32.1),		]},
	{
		NPCs:[
			{is_trainer:1,b1:9,b2:0,sprite:117},
			{is_trainer:1,b1:8,b2:0,sprite:118},
			{is_trainer:0,b1:8,b2:0,sprite:65},
			{is_trainer:0,b1:1,b2:0,sprite:65},
			{is_trainer:0,b1:2,b2:0,sprite:5},
		]},
	{
		signs:[
			{x:1,y:2},
			{x:1,y:3},
			{x:0,y:2},
			{x:0,y:3},
		]},
	{
		triggers:[
		]},

},
[
	[1, 1, 1, 1, 1, 1, 1, 1, 1, 1, 1, 1, 1, 1, 1, 1, 1, 1, 1, 1, ],
	[1, 1, 1, 1, 1, 1, 1, 1, 1, 1, 1, 1, 1, 1, 1, 1, 1, 0, 1, 1, ],
	[1, 1, 12, 1, 12, 12, 12, 1, 1, 1, 1, 1, 12, 12, 12, 12, 12, 12, 12, 1, ],
	[1, 1, 12, 1, 12, 12, 12, 1, 12, 12, 12, 12, 12, 12, 12, 12, 12, 12, 12, 12, ],
	[12, 12, 12, 1, 12, 12, 12, 1, 12, 12, 12, 1, 1, 12, 12, 12, 1, 1, 12, 12, ],
	[12, 12, 12, 1, 12, 12, 12, 1, 12, 12, 12, 1, 1, 12, 12, 12, 1, 1, 12, 12, ],
	[12, 12, 12, 12, 12, 12, 12, 12, 12, 12, 12, 1, 1, 12, 12, 12, 1, 1, 12, 12, ],
	[12, 1, 12, 12, 12, 12, 12, 12, 12, 12, 12, 12, 12, 12, 12, 12, 12, 12, 12, 1, ],
	[1, 1, 1, 1, 12, 12, 12, 1, 1, 1, 1, 1, 1, 1, 1, 1, 1, 1, 1, 1, ],
	[1, 1, 1, 1, 12, 12, 12, 1, 1, 1, 1, 1, 1, 1, 1, 1, 1, 1, 1, 1, ],
	[12, 12, 12, 12, 12, 12, 12, 12, 12, 12, 12, 12, 12, 12, 12, 12, 12, 12, 12, 12, ],
	[12, 12, 12, 12, 12, 12, 12, 12, 12, 12, 12, 12, 12, 12, 12, 12, 12, 12, 12, 12, ],
	[12, 12, 12, 12, 12, 12, 12, 12, 1, 0, 0, 1, 12, 12, 12, 12, 12, 12, 12, 12, ],
]
