connections=[
		],
events={
	
		'exits':[{'name':'ROUTE 113 (0.28)','x':3,'y':8},{'name':'ROUTE 113 (0.28)','x':4,'y':8},		],
	
		'NPCs':[
			{'is_trainer':0,'b1':8,'b2':0,'sprite':'19','x':2,'y':3},
			{'is_trainer':0,'b1':2,'b2':0,'sprite':'5','x':5,'y':4},
		],
	
		'signs':[
		],
	
		'triggers':[
		],

},
partial_map=[
	[1, 1, 1, 1, 1, 1, 1, 1, 1, 1, ],
	[1, 1, 1, 1, 1, 1, 1, 1, 1, 1, ],
	[12, 12, 12, 13, 13, 12, 12, 12, 12, 12, ],
	[12, 12, 12, 12, 12, 12, 12, 12, 12, 12, ],
	[12, 12, 12, 12, 12, 12, 12, 1, 1, 12, ],
	[12, 12, 12, 12, 12, 12, 12, 1, 1, 12, ],
	[12, 12, 12, 12, 12, 12, 12, 12, 12, 12, ],
	[12, 12, 12, 12, 12, 12, 12, 12, 12, 12, ],
	[12, 12, 12, 0, 0, 12, 12, 12, 12, 12, ],
]
