connections=[
		],
events={
	
		'exits':[{'name':'ROUTE 110 (29.0)','x':0,'y':21},{'name':'ROUTE 110 (29.0)','x':1,'y':21},{'name':'ROUTE 110 (29.1)','x':13,'y':1},		],
	
		'NPCs':[
			{'is_trainer':1,'b1':9,'b2':0,'sprite':'47','x':14,'y':20},
			{'is_trainer':1,'b1':9,'b2':0,'sprite':'35','x':14,'y':8},
			{'is_trainer':1,'b1':8,'b2':0,'sprite':'47','x':2,'y':15},
			{'is_trainer':0,'b1':1,'b2':0,'sprite':'82','x':11,'y':16},
			{'is_trainer':0,'b1':1,'b2':0,'sprite':'82','x':13,'y':18},
			{'is_trainer':0,'b1':1,'b2':0,'sprite':'82','x':14,'y':14},
			{'is_trainer':0,'b1':1,'b2':0,'sprite':'82','x':11,'y':8},
			{'is_trainer':0,'b1':1,'b2':0,'sprite':'82','x':8,'y':10},
			{'is_trainer':0,'b1':1,'b2':0,'sprite':'82','x':11,'y':12},
			{'is_trainer':0,'b1':1,'b2':0,'sprite':'82','x':2,'y':4},
			{'is_trainer':0,'b1':1,'b2':0,'sprite':'82','x':13,'y':6},
			{'is_trainer':0,'b1':1,'b2':0,'sprite':'82','x':0,'y':6},
			{'is_trainer':0,'b1':1,'b2':0,'sprite':'59','x':9,'y':4},
			{'is_trainer':0,'b1':1,'b2':0,'sprite':'82','x':4,'y':8},
			{'is_trainer':0,'b1':1,'b2':0,'sprite':'82','x':2,'y':12},
		],
	
		'signs':[
			{'x':3,'y':16},
		],
	
		'triggers':[
		],

},
partial_map=[
	[1, 1, 1, 1, 1, 1, 1, 1, 1, 1, 1, 1, 1, 1, 1, ],
	[1, 1, 1, 1, 1, 1, 1, 1, 1, 1, 1, 1, 1, 13, 1, ],
	[1, 1, 1, 1, 1, 1, 1, 1, 1, 1, 1, 1, 12, 12, 12, ],
	[12, 12, 1, 12, 12, 12, 1, 12, 1, 12, 12, 1, 12, 12, 12, ],
	[12, 12, 12, 12, 12, 12, 12, 12, 12, 12, 12, 1, 12, 12, 12, ],
	[12, 12, 1, 12, 12, 12, 1, 12, 1, 12, 12, 1, 12, 12, 12, ],
	[12, 1, 1, 1, 1, 1, 1, 1, 1, 1, 1, 1, 1, 12, 1, ],
	[12, 12, 12, 12, 1, 12, 12, 12, 12, 12, 12, 1, 12, 12, 12, ],
	[12, 1, 12, 12, 12, 12, 12, 12, 12, 12, 12, 12, 12, 12, 12, ],
	[12, 1, 12, 12, 1, 12, 12, 1, 1, 12, 12, 1, 12, 12, 12, ],
	[1, 1, 1, 12, 1, 1, 12, 12, 12, 12, 1, 1, 1, 1, 1, ],
	[12, 12, 1, 12, 12, 1, 12, 12, 1, 12, 12, 1, 12, 12, 12, ],
	[12, 12, 12, 12, 12, 1, 12, 12, 1, 12, 12, 12, 12, 12, 12, ],
	[12, 12, 1, 12, 12, 1, 12, 12, 1, 12, 12, 1, 12, 12, 12, ],
	[12, 12, 1, 1, 1, 1, 1, 1, 1, 1, 1, 1, 1, 1, 12, ],
	[12, 12, 12, 12, 1, 12, 1, 12, 12, 12, 12, 1, 12, 12, 12, ],
	[12, 12, 12, 1, 1, 12, 12, 12, 12, 12, 12, 12, 12, 12, 12, ],
	[12, 12, 12, 12, 1, 12, 12, 12, 12, 12, 12, 1, 12, 12, 12, ],
	[1, 1, 1, 1, 1, 1, 1, 1, 1, 1, 1, 1, 1, 12, 1, ],
	[12, 12, 12, 12, 1, 12, 12, 12, 12, 1, 12, 12, 12, 12, 12, ],
	[12, 12, 12, 12, 12, 12, 12, 12, 12, 12, 12, 12, 12, 12, 12, ],
	[12, 12, 12, 12, 12, 12, 12, 12, 12, 12, 12, 12, 12, 12, 12, ],
]
