Connections;
Exits;ROUTE 110 (29.0);ROUTE 110 (29.0);ROUTE 110 (29.1);ROUTE 110 (29.9);ROUTE 110 (29.9);ROUTE 110 (29.9);ROUTE 110 (29.9);ROUTE 110 (29.9);ROUTE 110 (29.9);ROUTE 110 (29.9);ROUTE 110 (29.9);ROUTE 110 (29.9);ROUTE 110 (29.9);
1 1 1 1 1 1 1 1 1 1 1 1 1 1 1 
1 1 1 1 1 1 1 1 1 1 1 1 1 13 1 
1 12 12 1 12 12 1 12 12 12 0 0 12 12 1 
1 0 0 1 0 12 1 0 12 12 0 0 1 1 1 
1 12 12 1 12 12 1 1 1 1 1 1 1 0 1 
1 12 12 1 12 1 1 1 1 12 12 12 1 12 1 
1 12 12 0 0 12 0 12 1 1 1 12 1 12 1 
1 1 1 0 0 1 12 12 12 0 12 12 1 12 1 
12 12 12 12 1 1 1 1 1 1 1 12 1 12 1 
12 1 1 1 1 12 12 12 12 12 12 12 1 12 1 
12 1 12 12 12 12 12 1 1 1 12 12 1 12 1 
0 1 12 1 1 1 1 1 12 1 1 12 1 0 1 
1 1 12 1 12 12 1 1 0 12 1 12 1 1 1 
12 12 12 1 0 12 1 1 12 1 1 12 1 12 1 
0 12 12 1 1 1 1 1 1 1 12 12 12 12 1 
12 12 12 12 12 12 12 12 12 12 12 12 1 12 1 
1 1 1 1 1 1 1 1 1 1 1 12 1 12 1 
1 0 12 0 0 12 1 1 0 0 1 12 1 12 1 
1 1 1 0 0 1 1 1 0 0 1 12 12 12 1 
12 12 1 1 1 1 12 12 0 12 12 12 1 12 1 
12 12 12 12 1 1 12 1 0 0 1 12 1 12 1 
12 12 12 12 12 12 12 1 0 0 1 1 1 1 1 
