Connections;
Exits;ROUTE 104 (0.19);ROUTE 104 (0.19);
1 1 1 1 1 1 1 1 1 1 1 1 1 1 1 
1 1 1 1 1 1 1 1 1 1 1 1 1 1 1 
12 1 12 12 12 12 12 1 1 12 1 1 1 1 12 
12 1 12 12 12 12 12 12 12 12 12 1 1 12 12 
12 1 12 12 12 12 12 12 12 12 12 12 12 12 12 
1 1 12 12 12 12 1 1 12 12 12 12 1 1 1 
12 12 12 12 12 1 1 1 1 12 12 12 1 1 1 
1 12 12 12 12 1 1 1 1 12 12 12 1 1 1 
1 12 0 0 12 12 12 12 12 12 12 12 12 12 12 
