connections=[
		],
events={
	{
		exits:[ROUTE 110 (0.25),ROUTE 110 (0.25),ROUTE 110 (0.25),ROUTE 110 (0.25),		]},
	{
		NPCs:[
			{is_trainer:0,b1:8,b2:0,sprite:83},
		]},
	{
		signs:[
		]},
	{
		triggers:[
			{x:7,y:4,flag:16385,scriptPointer:2550736},
			{x:5,y:4,flag:16385,scriptPointer:2550803},
		]},

},
[
	[1, 1, 1, 1, 1, 1, 1, 1, 1, 1, 1, 1, 1, 1, 1, ],
	[1, 1, 1, 1, 1, 1, 1, 1, 1, 1, 1, 1, 1, 1, 1, ],
	[12, 12, 12, 12, 12, 13, 12, 12, 12, 12, 13, 12, 12, 12, 12, ],
	[12, 12, 12, 12, 12, 13, 13, 13, 13, 13, 13, 12, 12, 12, 12, ],
	[12, 12, 12, 12, 12, 12, 12, 12, 12, 12, 12, 12, 12, 12, 12, ],
	[13, 0, 0, 12, 12, 12, 13, 13, 13, 13, 12, 12, 0, 0, 13, ],
]
