connections=[
		],
events={
	{
		exits:[ROUTE 109 (0.24),ROUTE 109 (0.24),		]},
	{
		NPCs:[
			{is_trainer:0,b1:8,b2:0,sprite:25},
			{is_trainer:1,b1:8,b2:0,sprite:49},
			{is_trainer:1,b1:9,b2:0,sprite:54},
			{is_trainer:1,b1:14,b2:0,sprite:45},
		]},
	{
		signs:[
		]},
	{
		triggers:[
		]},

},
[
	[1, 1, 1, 1, 1, 1, 1, 1, 1, 1, 1, 1, 1, 1, 1, ],
	[1, 1, 1, 1, 1, 1, 1, 1, 1, 1, 1, 1, 1, 1, 1, ],
	[12, 1, 1, 12, 12, 12, 12, 1, 12, 12, 12, 12, 1, 1, 12, ],
	[12, 12, 12, 12, 12, 12, 12, 12, 12, 12, 12, 12, 12, 12, 12, ],
	[1, 1, 12, 1, 1, 1, 12, 12, 1, 1, 1, 12, 12, 1, 1, ],
	[12, 12, 12, 12, 12, 12, 12, 12, 12, 12, 12, 12, 12, 12, 12, ],
	[1, 1, 12, 1, 1, 1, 12, 12, 1, 1, 1, 12, 12, 1, 1, ],
	[12, 12, 12, 12, 12, 12, 12, 12, 12, 12, 12, 12, 12, 12, 12, ],
	[1, 1, 12, 12, 12, 12, 12, 12, 12, 12, 12, 12, 12, 1, 1, ],
	[12, 12, 12, 12, 12, 12, 0, 0, 12, 12, 12, 12, 12, 12, 12, ],
]
