connections=[
		],
events={
	
		'exits':[{'name':'ROUTE 110 (29.0)','x':0,'y':21},{'name':'ROUTE 110 (29.0)','x':1,'y':21},{'name':'ROUTE 110 (29.1)','x':13,'y':1},		],
	
		'NPCs':[
			{'is_trainer':1,'b1':8,'b2':0,'sprite':'31','x':7,'y':19},
			{'is_trainer':1,'b1':10,'b2':0,'sprite':'32','x':4,'y':4},
			{'is_trainer':1,'b1':8,'b2':0,'sprite':'55','x':10,'y':10},
			{'is_trainer':0,'b1':1,'b2':0,'sprite':'59','x':1,'y':2},
			{'is_trainer':0,'b1':1,'b2':0,'sprite':'59','x':4,'y':2},
			{'is_trainer':0,'b1':1,'b2':0,'sprite':'86','x':1,'y':20},
			{'is_trainer':0,'b1':1,'b2':0,'sprite':'86','x':2,'y':21},
		],
	
		'signs':[
			{'x':0,'y':14},
		],
	
		'triggers':[
			{'x':4,'y':14,'flag':16385,'scriptPointer':2540749},
			{'x':3,'y':11,'flag':16386,'scriptPointer':2540761},
			{'x':12,'y':5,'flag':16387,'scriptPointer':2540773},
			{'x':8,'y':2,'flag':16388,'scriptPointer':2540785},
		],

},
partial_map=[
	[1, 1, 1, 1, 1, 1, 1, 1, 1, 1, 1, 1, 1, 1, 1, ],
	[1, 1, 1, 1, 1, 1, 1, 1, 1, 1, 1, 1, 1, 13, 1, ],
	[1, 12, 12, 1, 12, 12, 1, 12, 12, 1, 12, 12, 1, 12, 12, ],
	[1, 12, 12, 1, 12, 12, 1, 12, 12, 1, 12, 12, 1, 12, 12, ],
	[1, 1, 1, 1, 12, 12, 1, 12, 12, 1, 12, 12, 1, 1, 1, ],
	[12, 12, 12, 12, 12, 12, 12, 12, 12, 1, 12, 12, 12, 12, 12, ],
	[1, 12, 12, 1, 12, 12, 1, 12, 12, 1, 12, 12, 1, 12, 12, ],
	[1, 12, 12, 1, 1, 1, 1, 12, 12, 1, 1, 1, 1, 12, 12, ],
	[12, 12, 12, 12, 12, 12, 12, 12, 12, 1, 12, 12, 12, 12, 12, ],
	[1, 12, 12, 1, 1, 1, 1, 12, 12, 1, 12, 12, 1, 12, 12, ],
	[1, 12, 12, 1, 1, 1, 1, 1, 1, 1, 12, 12, 1, 12, 12, ],
	[12, 12, 12, 12, 12, 12, 12, 12, 12, 12, 12, 12, 12, 12, 12, ],
	[1, 12, 12, 1, 12, 12, 1, 12, 12, 1, 12, 12, 1, 12, 12, ],
	[1, 1, 1, 1, 1, 1, 1, 12, 12, 1, 1, 1, 1, 12, 12, ],
	[1, 12, 12, 12, 12, 12, 12, 12, 12, 12, 12, 12, 1, 12, 12, ],
	[1, 1, 1, 1, 12, 12, 1, 1, 1, 1, 12, 12, 1, 12, 12, ],
	[1, 1, 1, 1, 12, 12, 1, 1, 1, 1, 12, 12, 1, 12, 12, ],
	[12, 12, 12, 1, 12, 12, 1, 12, 12, 12, 12, 12, 12, 12, 12, ],
	[1, 12, 12, 1, 12, 12, 1, 12, 12, 1, 12, 12, 1, 12, 12, ],
	[1, 12, 12, 1, 1, 1, 1, 12, 12, 1, 1, 1, 1, 12, 12, ],
	[12, 12, 12, 12, 12, 12, 12, 12, 12, 12, 12, 12, 12, 12, 12, ],
	[12, 12, 12, 12, 12, 12, 12, 12, 12, 12, 12, 12, 12, 12, 12, ],
]
