connections=[
		],
events={
	{
		exits:[ROUTE 110 (29.0),ROUTE 110 (29.0),ROUTE 110 (29.1),		]},
	{
		NPCs:[
			{is_trainer:1,b1:8,b2:0,sprite:14},
			{is_trainer:1,b1:9,b2:0,sprite:14},
			{is_trainer:1,b1:10,b2:0,sprite:44},
			{is_trainer:0,b1:1,b2:0,sprite:59},
			{is_trainer:0,b1:1,b2:0,sprite:87},
			{is_trainer:0,b1:1,b2:0,sprite:87},
			{is_trainer:0,b1:1,b2:0,sprite:87},
			{is_trainer:0,b1:1,b2:0,sprite:87},
			{is_trainer:0,b1:1,b2:0,sprite:87},
			{is_trainer:0,b1:1,b2:0,sprite:87},
			{is_trainer:0,b1:1,b2:0,sprite:87},
			{is_trainer:0,b1:1,b2:0,sprite:87},
			{is_trainer:0,b1:1,b2:0,sprite:87},
			{is_trainer:0,b1:1,b2:0,sprite:87},
		]},
	{
		signs:[
			{x:14,y:13},
		]},
	{
		triggers:[
		]},

},
[
	[1, 1, 1, 1, 1, 1, 1, 1, 1, 1, 1, 1, 1, 1, 1, ],
	[1, 1, 1, 1, 1, 1, 1, 1, 1, 1, 1, 1, 1, 13, 1, ],
	[12, 12, 12, 12, 1, 1, 12, 12, 12, 12, 12, 1, 12, 12, 12, ],
	[12, 12, 12, 12, 12, 1, 12, 12, 12, 12, 1, 1, 12, 12, 12, ],
	[12, 12, 1, 1, 12, 1, 1, 12, 1, 12, 1, 12, 12, 12, 12, ],
	[12, 12, 12, 1, 12, 12, 12, 12, 1, 12, 1, 12, 12, 1, 1, ],
	[12, 12, 12, 1, 12, 12, 12, 12, 1, 12, 1, 1, 12, 1, 12, ],
	[1, 1, 1, 12, 12, 12, 12, 12, 1, 12, 12, 12, 12, 12, 12, ],
	[12, 12, 12, 12, 12, 1, 12, 12, 1, 12, 12, 12, 12, 12, 12, ],
	[12, 12, 12, 12, 12, 1, 12, 12, 12, 1, 1, 1, 1, 1, 1, ],
	[12, 12, 12, 12, 12, 1, 12, 12, 12, 12, 12, 12, 12, 12, 12, ],
	[12, 12, 1, 1, 1, 1, 1, 1, 1, 1, 12, 12, 12, 12, 12, ],
	[12, 12, 1, 12, 12, 12, 12, 1, 12, 12, 12, 12, 1, 1, 1, ],
	[12, 1, 1, 12, 12, 1, 12, 12, 12, 1, 12, 12, 1, 12, 1, ],
	[12, 1, 12, 12, 12, 1, 1, 1, 1, 1, 12, 1, 1, 12, 12, ],
	[12, 1, 12, 12, 12, 1, 12, 12, 12, 12, 12, 12, 1, 12, 12, ],
	[12, 1, 1, 1, 12, 12, 12, 12, 12, 1, 12, 12, 12, 12, 12, ],
	[12, 1, 12, 12, 12, 1, 12, 12, 12, 12, 12, 12, 12, 12, 12, ],
	[12, 1, 1, 1, 1, 1, 1, 1, 1, 1, 1, 1, 1, 1, 1, ],
	[12, 12, 12, 12, 12, 12, 12, 12, 12, 12, 12, 12, 12, 12, 12, ],
	[12, 12, 12, 12, 12, 12, 12, 12, 12, 12, 12, 12, 12, 12, 12, ],
	[12, 12, 12, 12, 12, 12, 12, 12, 12, 12, 12, 12, 12, 12, 12, ],
]
