Connections;down:ROUTE 118 (0.33);right:FORTREE CITY (0.4);
Exits;ROUTE 119 (32.0);
1 1 1 1 1 1 1 1 1 1 1 1 1 1 1 1 5 5 1 1 1 1 1 1 1 1 1 1 1 1 1 1 1 1 1 1 1 1 1 1 
1 1 1 1 1 1 1 1 1 1 1 1 1 1 1 1 5 5 1 1 1 1 1 1 1 1 1 1 1 1 1 1 1 1 1 1 1 1 1 1 
1 1 1 1 1 1 1 1 1 1 1 1 1 5 5 5 5 5 1 1 1 1 1 1 1 1 1 1 1 1 1 1 1 1 1 1 1 1 1 1 
1 1 1 1 12 12 12 12 1 1 1 1 1 5 5 5 5 5 1 1 1 1 1 1 1 1 1 1 1 1 1 1 1 1 1 1 1 1 1 1 
1 1 1 1 1 1 1 0 1 5 5 5 5 5 5 5 5 5 1 1 1 1 1 1 1 1 1 1 1 1 1 1 1 1 1 1 1 1 1 1 
1 1 1 1 1 1 16 16 16 16 16 5 5 5 5 5 5 5 1 16 1 1 1 12 13 13 13 12 1 1 1 1 1 1 1 12 12 1 1 1 
1 1 1 1 1 16 16 16 1 1 16 5 5 5 5 5 5 5 1 16 1 1 1 12 12 12 12 12 1 12 1 12 1 12 12 12 12 12 12 12 
1 1 1 1 1 16 1 1 1 5 16 16 16 16 16 16 16 16 16 16 1 1 1 1 12 12 12 12 12 12 12 12 12 12 12 12 12 12 12 12 
1 1 1 1 1 16 5 5 5 5 1 1 1 1 1 1 1 1 1 16 1 1 1 1 1 1 12 12 12 12 12 12 12 12 12 12 12 12 12 12 
1 1 1 1 1 16 5 5 5 5 5 5 5 5 5 5 5 5 1 16 1 1 1 1 1 1 1 12 13 12 12 12 12 12 12 12 12 12 12 12 
1 1 13 1 5 16 16 16 16 16 5 16 16 16 16 16 16 16 16 16 16 1 1 1 1 1 1 1 12 12 12 12 12 12 12 12 12 12 12 12 
1 1 5 5 5 5 5 5 5 16 5 1 1 1 1 1 1 1 1 16 16 1 1 1 1 1 1 1 12 12 12 12 12 12 12 1 1 1 1 1 
1 1 5 5 5 5 5 5 5 16 5 5 5 5 5 5 5 5 1 16 16 1 1 1 1 1 1 1 12 12 12 12 12 1 12 1 1 1 1 1 
1 12 12 12 12 12 12 1 5 16 5 5 5 5 5 5 5 5 1 16 16 1 1 1 1 1 1 1 1 12 12 12 12 1 12 1 1 1 1 1 
1 1 1 1 1 1 1 1 5 16 5 5 5 5 5 5 5 5 5 13 16 1 1 1 1 1 1 1 12 12 12 12 12 1 12 1 1 1 1 1 
1 1 1 1 1 1 1 1 5 16 5 13 13 13 13 5 5 5 5 1 16 1 1 1 12 12 12 12 12 12 12 12 12 1 12 1 1 1 1 1 
1 1 1 12 12 12 12 12 12 0 12 1 1 1 1 1 5 16 16 16 16 1 1 1 1 1 1 1 12 12 12 12 1 1 12 1 1 1 1 1 
1 1 1 1 1 1 12 12 12 12 12 1 1 1 1 1 5 16 1 1 16 1 1 1 1 1 1 1 12 12 12 12 1 1 12 12 1 1 1 1 
1 1 1 1 1 1 1 12 12 12 12 1 1 12 0 16 16 16 4 1 1 1 1 1 1 1 1 1 12 12 12 12 1 1 12 12 1 1 1 1 
1 1 1 1 1 1 1 13 13 13 13 1 12 12 12 1 1 1 4 4 1 1 1 1 1 1 1 1 12 12 12 12 1 1 12 12 1 1 1 1 
1 1 1 1 1 1 1 12 12 12 12 12 12 12 12 1 4 4 4 4 1 1 1 1 1 1 1 12 12 12 12 12 12 1 12 12 1 1 1 1 
1 1 1 1 1 1 1 12 12 12 12 12 12 12 12 1 12 4 4 4 1 1 1 1 1 1 1 12 12 12 12 12 12 12 12 12 1 1 1 1 
1 1 1 1 1 1 1 12 12 12 12 12 1 12 12 1 12 4 4 4 1 1 1 1 1 1 12 12 12 12 12 12 12 12 12 12 1 1 1 1 
1 1 1 1 1 1 1 12 13 13 12 12 1 12 12 12 12 4 4 4 1 1 1 1 1 1 12 12 12 12 12 12 12 12 12 12 12 1 1 1 
1 1 1 1 1 1 1 1 1 1 1 1 1 12 12 12 12 4 4 4 1 1 1 1 1 1 12 12 12 12 12 12 12 1 1 1 12 1 1 1 
1 1 1 1 1 1 1 1 1 1 1 12 1 1 1 1 1 4 4 4 1 1 1 1 1 1 12 12 12 12 12 12 12 12 12 12 12 1 1 1 
1 1 1 1 1 1 1 1 1 1 1 1 1 1 1 1 1 4 4 4 1 1 1 1 1 1 1 12 12 1 1 1 1 12 12 12 12 1 1 1 
1 1 1 1 1 1 1 1 1 1 1 1 1 1 1 1 1 4 4 4 1 1 1 1 1 1 1 12 12 1 1 1 1 12 12 12 1 1 1 1 
1 1 1 1 1 1 1 1 1 1 1 1 16 16 1 1 1 4 4 4 1 1 1 1 12 12 12 12 12 12 12 1 1 1 1 1 1 1 1 1 
1 1 1 1 1 1 1 1 1 1 1 1 16 16 1 1 12 4 4 4 12 1 1 1 12 12 12 12 12 12 12 1 1 1 1 1 1 1 1 1 
1 1 1 1 1 1 1 1 1 1 1 1 16 16 1 1 12 4 4 4 12 1 1 1 12 12 12 12 12 12 12 1 12 1 1 1 1 1 1 1 
1 1 1 1 1 1 1 1 1 1 1 1 16 16 1 1 4 4 4 4 4 1 1 1 1 12 12 1 1 1 1 1 1 1 1 1 1 1 1 1 
1 1 1 1 1 1 0 1 1 1 16 16 16 16 1 1 4 4 4 4 4 1 1 12 12 12 12 12 12 12 1 12 1 1 1 1 1 1 1 1 
1 1 1 16 16 0 12 0 16 1 16 16 16 16 16 16 60 60 60 60 60 16 16 0 12 12 12 12 12 12 1 1 1 1 1 1 1 1 1 1 
1 1 1 16 16 16 0 16 16 16 16 16 16 16 16 16 60 60 60 60 60 16 16 0 12 12 12 12 12 12 12 12 1 1 1 1 1 1 1 1 
1 1 1 1 1 16 16 16 16 16 16 16 16 16 1 1 4 4 4 4 4 1 1 12 12 12 12 12 12 12 12 12 1 1 1 1 1 1 1 1 
1 1 1 1 1 16 16 16 16 16 16 16 16 16 1 1 4 4 4 4 4 1 1 1 12 12 1 1 1 1 12 12 12 1 1 1 1 1 1 1 
1 1 1 1 1 1 16 16 16 16 16 16 16 16 1 1 4 4 4 4 4 1 1 1 12 12 12 12 12 1 12 12 1 1 1 1 1 1 1 1 
1 1 1 1 1 1 1 16 16 16 16 16 16 16 1 1 4 4 4 4 4 4 4 1 12 12 12 12 12 1 12 1 1 1 1 1 1 1 1 1 
1 1 1 1 1 1 1 16 16 16 16 16 16 16 1 1 4 4 4 4 4 4 4 1 0 12 12 12 12 1 1 1 1 1 1 1 1 1 1 1 
1 1 1 1 1 1 1 16 16 16 16 16 16 16 1 1 4 4 4 4 4 4 4 1 12 12 12 12 12 12 1 1 1 1 1 1 1 1 1 1 
1 1 1 1 1 1 1 16 16 16 16 16 16 16 1 1 4 4 4 4 4 4 4 1 1 12 1 1 1 1 1 1 1 1 1 1 1 1 1 1 
1 1 1 1 1 1 1 16 16 16 16 16 16 16 1 1 4 4 4 4 4 4 4 4 12 12 1 1 1 1 1 1 1 1 1 1 1 1 1 1 
1 1 1 1 1 1 1 16 16 16 16 16 16 16 1 1 4 4 4 4 4 4 4 4 4 4 4 4 4 4 4 1 1 1 1 1 1 1 1 1 
1 1 1 1 1 1 1 16 16 16 16 16 16 16 16 16 16 16 16 1 4 4 4 4 4 4 4 4 4 4 4 4 4 1 1 1 1 1 1 1 
1 1 1 1 1 1 1 16 16 16 16 16 16 16 16 16 16 16 16 16 1 4 4 4 4 4 4 4 4 4 4 4 4 1 1 1 1 1 1 1 
1 1 1 1 1 1 1 16 16 16 16 16 16 16 16 16 16 16 16 16 16 16 16 1 4 4 4 4 4 4 4 4 4 4 4 1 1 1 1 1 
1 1 1 1 1 1 1 16 16 16 16 16 16 16 16 16 16 16 16 16 16 16 16 1 16 16 16 1 4 4 4 4 4 4 4 12 1 1 1 1 
1 1 1 1 1 1 1 16 16 16 16 16 16 16 16 16 16 16 1 1 1 0 0 1 16 16 16 1 1 1 4 4 4 4 4 12 1 1 1 1 
1 1 1 1 1 1 1 16 16 16 16 16 16 16 16 16 16 16 1 12 12 12 12 12 0 16 16 1 1 1 1 4 4 4 4 4 1 1 1 1 
1 1 1 1 1 1 1 16 16 16 16 16 16 16 16 1 1 1 1 12 12 12 12 12 12 1 1 1 1 1 1 4 4 4 1 1 12 1 1 1 
1 1 1 1 1 16 16 16 16 16 16 16 16 16 16 1 12 12 12 12 12 12 12 12 1 1 12 12 1 1 1 4 4 4 1 1 12 1 1 1 
1 12 1 1 1 0 0 0 0 0 1 1 1 1 1 1 12 12 12 12 12 12 1 1 1 12 12 12 12 1 1 4 4 4 4 4 12 1 1 1 
1 1 1 1 1 12 12 12 12 1 1 1 1 1 1 1 1 1 1 12 12 1 1 12 12 12 12 12 12 12 1 4 4 4 4 4 12 1 1 1 
1 1 1 1 1 1 12 1 1 1 1 1 1 1 12 12 12 12 12 12 12 12 12 12 12 12 12 12 12 12 1 1 1 4 4 4 1 1 1 1 
1 1 1 1 1 1 12 1 1 1 1 1 12 12 12 12 12 12 12 12 1 1 1 1 1 12 12 12 12 1 1 1 1 4 4 4 1 1 1 1 
1 1 1 12 12 12 12 12 12 12 12 12 12 12 12 12 12 12 12 1 1 1 1 1 1 1 12 12 12 1 1 4 4 4 4 4 1 1 1 1 
1 1 1 12 12 12 12 12 1 1 1 12 12 12 12 12 12 12 12 1 1 1 1 1 1 1 1 1 1 1 1 4 4 4 4 4 1 1 1 1 
1 1 1 1 12 12 12 12 1 1 1 12 12 12 12 12 12 12 1 1 1 1 1 1 1 1 1 1 1 1 4 4 4 4 4 4 1 1 1 1 
1 1 1 1 12 12 12 12 1 1 1 1 12 12 12 12 12 12 1 1 1 1 1 1 1 1 1 4 4 4 4 4 4 4 4 12 12 1 1 1 
1 1 1 1 12 12 12 12 1 1 1 1 12 12 12 12 12 12 1 1 1 1 1 1 1 1 4 4 4 4 4 4 4 4 12 12 12 12 12 1 
1 1 1 1 1 12 12 12 1 1 1 1 12 12 12 12 12 12 1 1 1 1 1 1 1 1 4 4 4 4 4 4 1 1 12 1 12 12 12 12 
1 1 1 1 1 12 12 12 1 1 1 1 12 12 12 12 12 1 1 1 1 1 1 1 1 1 4 4 4 4 4 4 1 1 1 1 12 12 12 12 
1 1 1 1 1 1 12 12 12 12 1 1 1 12 12 12 12 1 1 1 1 1 1 1 1 1 4 4 4 4 4 4 4 12 1 1 12 12 12 12 
1 1 1 1 1 1 1 12 12 12 1 1 1 12 12 12 12 1 1 1 1 1 1 1 4 4 4 4 4 4 12 12 12 12 1 1 12 12 12 12 
1 1 1 1 1 1 1 12 12 12 1 1 12 12 12 12 1 1 1 1 1 1 1 1 4 4 4 4 4 12 12 12 12 12 12 1 1 12 12 12 
1 1 1 1 1 1 1 12 12 12 12 12 12 12 12 12 1 1 1 1 1 1 4 4 4 4 4 4 4 12 12 12 12 12 12 1 1 1 1 1 
1 1 1 1 1 1 1 12 12 12 12 12 12 12 12 12 1 1 1 1 1 1 4 4 4 4 4 4 4 12 1 12 12 12 12 1 1 1 1 1 
1 1 1 1 1 1 1 12 12 12 12 12 12 12 12 1 1 1 1 1 1 1 4 4 4 4 4 12 12 1 1 12 12 12 1 1 1 1 1 1 
1 1 1 1 1 1 1 1 12 12 12 12 12 12 12 1 1 1 1 1 4 4 4 4 4 4 4 12 12 1 1 12 12 12 1 1 1 1 1 1 
1 1 1 1 1 1 1 1 12 12 12 12 12 12 1 1 1 1 1 1 4 4 4 4 4 4 12 12 1 1 12 12 12 1 1 1 1 1 1 1 
1 1 1 1 1 1 1 1 12 12 12 12 12 12 1 1 1 1 1 1 4 4 4 4 4 4 12 1 1 12 12 12 12 1 1 1 1 1 1 1 
1 1 1 1 1 1 1 1 12 12 12 12 12 12 1 1 1 1 1 1 4 4 4 4 4 4 12 1 1 12 12 12 12 1 1 1 1 1 1 1 
1 1 1 1 1 1 1 12 12 12 12 12 12 12 1 1 1 1 1 1 4 4 4 4 12 12 1 1 1 12 13 13 13 1 1 1 1 1 1 1 
1 1 1 1 1 1 1 12 12 12 12 12 12 1 1 1 1 1 1 1 12 4 1 1 12 12 1 1 1 12 12 12 12 1 1 1 1 1 1 1 
1 1 1 1 1 1 1 12 12 12 12 12 12 1 1 1 1 1 12 12 12 4 1 1 12 12 1 1 1 1 1 1 1 1 1 1 1 1 1 1 
1 1 1 1 1 1 12 12 12 12 12 12 1 1 1 1 1 1 1 1 12 5 5 5 1 12 1 1 1 1 1 1 1 1 1 1 1 1 1 1 
1 1 1 1 1 12 12 12 12 12 12 12 1 1 1 1 1 1 12 12 12 5 5 5 1 12 1 1 1 1 1 1 1 1 1 1 1 1 1 1 
1 12 1 1 12 12 12 12 12 12 12 12 1 1 1 1 1 1 1 1 1 5 5 5 1 1 1 1 1 1 1 1 1 1 1 1 1 1 1 1 
1 12 1 1 12 12 12 12 12 1 1 1 1 1 1 1 1 1 1 1 1 5 5 5 1 1 1 1 1 1 1 1 1 1 1 1 1 1 1 1 
1 12 1 1 1 0 0 1 1 1 1 1 1 1 1 1 1 1 1 1 1 5 5 5 1 1 1 1 1 1 1 12 12 1 1 1 1 1 1 1 
1 12 1 16 16 16 16 1 1 1 1 1 1 1 1 1 1 1 1 1 1 5 5 5 1 1 1 1 1 1 1 1 1 1 1 1 1 1 1 1 
1 12 1 16 16 16 16 1 1 1 1 1 1 12 12 12 12 12 1 1 1 5 5 5 1 12 12 12 1 1 1 1 1 1 1 1 1 1 1 1 
1 12 1 16 16 16 16 1 1 1 12 12 12 12 12 12 12 12 1 1 1 1 1 1 1 12 12 12 1 1 1 1 1 1 16 16 16 16 1 1 
1 12 1 16 16 16 16 16 16 16 16 16 16 60 16 16 16 16 16 16 16 60 60 60 16 16 60 60 16 16 16 16 16 16 16 16 16 16 1 1 
1 1 1 16 16 16 16 16 16 16 16 16 16 60 16 16 16 16 16 16 16 60 60 60 16 16 60 60 16 16 16 16 16 16 16 16 16 16 1 1 
12 1 1 1 1 1 1 1 1 1 1 1 1 12 1 1 1 1 1 1 1 1 1 1 1 1 12 12 1 1 1 1 1 1 16 16 16 1 1 1 
1 1 1 1 1 1 1 1 1 1 1 1 1 12 1 1 1 1 1 1 1 1 1 1 1 1 12 12 12 1 1 1 1 1 16 16 16 1 16 1 
1 12 1 1 1 1 12 12 12 12 12 12 12 12 12 1 1 1 1 1 1 1 1 1 1 1 1 12 12 12 12 12 1 1 1 16 16 1 16 1 
1 1 1 1 1 1 12 12 12 12 12 12 12 12 12 12 1 1 1 1 1 1 1 1 1 1 1 12 12 12 12 12 1 16 1 16 16 1 1 1 
1 1 1 12 12 12 12 12 12 12 12 12 12 12 12 12 12 12 1 1 1 1 1 1 1 1 1 12 12 13 13 12 1 16 16 16 16 16 1 12 
1 1 1 1 12 12 12 12 1 1 12 12 12 12 12 12 12 0 16 16 16 16 1 1 1 1 12 12 12 1 16 16 16 16 16 16 16 16 1 12 
1 1 1 1 12 12 12 12 1 1 1 12 12 12 12 12 12 12 1 1 1 16 1 1 1 12 12 12 12 1 16 16 16 16 16 16 16 16 1 1 
1 1 1 1 1 1 1 1 1 1 1 1 1 12 12 1 1 1 1 1 1 16 1 1 1 12 12 12 12 1 16 16 16 16 16 16 16 16 1 1 
1 1 1 1 1 1 1 1 1 1 1 1 1 1 1 1 1 1 1 1 1 16 16 16 16 0 12 12 12 1 16 16 16 16 16 16 16 16 1 1 
1 1 1 1 1 1 1 1 1 1 1 1 1 1 1 1 1 1 1 1 1 1 1 1 1 12 12 12 12 1 16 16 16 1 1 1 1 1 1 1 
1 1 1 1 12 12 12 12 12 12 12 1 1 1 1 1 1 1 1 1 1 1 1 1 1 12 12 12 12 1 16 16 16 1 1 1 1 1 1 1 
1 1 12 12 12 12 12 12 12 12 12 12 1 1 1 1 1 1 1 1 1 1 1 1 1 1 12 12 12 1 0 0 1 1 1 1 1 1 1 1 
1 1 12 12 12 12 12 12 12 12 12 12 12 1 4 1 1 1 1 1 1 1 1 1 1 1 12 12 12 12 12 12 12 1 1 1 1 1 1 1 
1 1 12 12 12 12 12 12 12 12 12 12 12 1 4 1 1 1 1 1 1 1 1 1 1 1 12 12 12 12 12 12 1 1 1 1 1 1 1 1 
1 1 1 1 12 12 12 12 12 12 12 12 12 1 4 4 4 1 1 4 4 1 1 4 4 1 12 12 12 12 12 12 1 1 1 1 1 1 1 1 
1 1 1 1 1 12 1 1 1 12 12 12 12 1 4 4 4 4 4 4 4 4 4 4 4 1 12 12 12 12 12 12 12 1 1 1 1 1 1 1 
1 1 1 1 1 1 12 12 12 12 12 12 12 1 4 4 4 4 4 4 4 4 4 4 4 1 12 12 12 12 12 12 12 1 1 1 1 1 1 1 
1 1 1 1 1 1 1 12 12 12 5 12 12 1 4 4 4 4 4 4 4 4 4 4 4 5 1 1 1 1 12 12 1 1 1 1 1 1 1 1 
1 1 1 1 1 1 1 1 1 12 5 12 12 12 4 4 4 4 4 4 4 4 4 4 4 4 1 1 12 12 12 12 12 1 1 1 1 1 1 1 
1 1 1 1 1 1 1 1 5 1 1 12 12 12 4 4 4 4 4 4 4 4 4 4 4 4 1 1 12 12 12 12 1 1 1 1 1 1 1 1 
1 1 1 5 5 1 1 1 5 4 4 4 4 4 4 4 4 4 4 4 4 1 1 4 4 4 1 12 12 12 12 12 1 1 1 1 1 1 1 1 
1 1 5 5 5 1 1 4 4 4 4 4 4 4 4 4 4 4 4 4 4 1 1 4 4 4 12 12 12 12 12 12 1 1 1 1 1 1 1 1 
1 1 5 5 5 1 1 1 1 4 4 4 4 4 4 4 4 4 4 4 4 4 4 4 4 4 12 12 12 12 12 12 1 1 1 1 1 1 1 1 
1 1 5 5 5 5 5 1 1 4 4 4 4 4 4 4 4 4 4 4 4 4 4 4 12 12 12 12 12 12 12 12 1 1 1 1 1 1 1 1 
1 1 5 5 5 5 1 1 4 4 4 4 4 4 4 4 4 4 4 4 12 12 12 12 12 12 12 12 12 12 12 12 12 12 12 12 1 1 1 1 
5 5 5 5 5 5 1 1 4 4 4 4 4 1 1 1 1 12 12 12 12 12 12 12 12 12 12 12 12 12 12 12 12 12 12 12 12 1 1 1 
5 5 5 5 5 1 1 4 4 1 1 1 1 1 1 1 1 12 12 12 12 12 12 12 12 12 12 12 12 12 12 12 12 12 12 12 12 12 1 1 
5 5 5 5 5 1 1 1 1 1 1 1 1 1 1 1 12 12 12 12 12 12 12 12 12 12 12 12 12 12 12 12 12 12 12 12 12 12 1 1 
5 5 5 5 5 5 5 1 1 1 1 1 1 1 1 12 12 12 12 12 12 12 12 12 12 12 12 12 12 12 12 12 12 12 12 12 12 12 1 1 
1 1 1 1 1 1 1 1 1 1 1 1 1 1 12 12 12 12 12 12 12 12 12 12 12 12 12 12 12 12 12 12 12 12 12 12 12 12 1 1 
1 1 1 1 1 1 1 1 1 1 1 12 12 12 12 12 12 12 12 12 12 12 12 12 12 12 12 12 12 12 12 12 12 12 12 12 12 12 1 1 
1 1 1 1 1 1 1 1 1 1 12 12 12 12 12 12 12 12 12 12 12 12 12 12 12 12 12 12 12 12 12 12 12 12 12 12 12 12 12 1 
1 1 1 1 1 1 1 1 1 12 12 12 12 12 12 12 12 12 12 12 12 12 12 12 12 12 12 12 12 12 12 12 12 12 12 12 12 12 12 1 
1 1 1 1 1 1 1 1 1 12 12 12 12 12 12 12 12 12 12 12 12 12 12 12 12 12 12 12 12 12 12 12 12 12 12 12 12 12 12 1 
1 1 1 1 1 1 1 12 12 12 12 12 12 12 12 12 12 12 12 12 12 12 12 12 12 12 12 12 12 12 12 12 12 12 12 12 12 12 12 1 
1 1 1 1 1 1 12 12 12 12 12 12 12 12 12 12 12 12 12 12 12 12 12 12 12 12 12 12 12 12 12 12 12 12 12 12 12 12 12 12 
1 1 1 1 1 12 12 12 12 12 12 12 12 12 12 12 12 1 1 1 1 12 12 12 12 12 12 12 12 12 12 12 12 12 12 12 12 12 12 12 
1 1 1 1 12 12 12 12 12 12 12 12 12 12 12 12 12 1 1 1 1 1 12 12 12 12 12 12 12 12 12 12 12 12 12 12 12 12 12 12 
1 1 1 1 12 12 12 12 12 12 12 12 12 12 12 12 12 1 1 1 1 1 12 12 12 12 12 12 12 12 12 12 12 12 12 12 12 12 12 12 
1 1 1 1 12 12 12 12 12 12 12 12 12 12 12 12 12 12 12 1 1 1 12 12 12 12 12 12 12 12 12 12 12 12 12 12 12 12 12 12 
1 1 1 12 12 12 12 12 12 12 12 12 12 12 12 12 12 12 12 12 12 12 12 12 12 12 12 12 12 1 1 12 12 12 12 12 12 12 12 12 
1 1 1 12 12 12 12 12 12 12 12 12 12 12 12 12 12 12 12 12 12 12 12 12 12 12 12 12 12 1 1 1 12 12 12 12 12 12 12 12 
1 1 1 12 12 12 12 12 12 12 12 12 12 12 12 12 12 12 12 12 12 12 12 12 12 12 12 12 12 1 1 1 12 12 12 12 12 12 12 1 
1 1 12 12 12 12 12 12 12 12 12 12 12 12 12 12 12 12 12 12 12 12 12 12 12 12 12 12 12 12 12 12 12 12 12 12 12 12 12 1 
1 1 12 12 12 12 12 12 12 12 12 12 12 12 12 12 12 12 12 12 12 12 12 12 12 12 12 12 12 12 12 12 12 12 12 12 12 12 1 1 
1 1 12 12 12 12 12 12 12 12 12 12 12 12 12 12 12 12 12 12 12 12 12 12 12 12 12 12 12 12 12 12 12 12 12 12 12 1 1 1 
1 1 1 1 1 12 12 12 12 12 12 12 12 12 12 12 12 12 12 12 12 12 12 12 12 12 12 12 12 12 12 12 12 12 12 1 1 1 1 1 
1 1 1 1 1 1 1 1 1 1 12 12 12 12 12 12 12 12 12 12 12 12 12 12 12 12 12 12 1 1 1 1 1 1 1 1 1 1 1 1 
1 1 1 1 1 1 1 1 1 1 1 1 1 1 1 12 12 12 12 12 12 12 1 1 1 1 1 1 1 1 1 1 1 1 1 1 1 1 1 1 
1 1 1 1 1 1 1 1 1 1 1 1 1 1 1 1 12 12 12 12 12 1 1 1 1 1 1 1 1 1 1 1 1 1 1 1 1 1 1 1 
1 1 1 1 1 1 1 1 1 1 1 1 1 1 1 1 12 12 12 12 12 1 1 1 1 1 1 1 1 1 1 1 1 1 1 1 1 1 1 1 
1 1 1 1 1 1 1 1 1 1 1 1 1 1 1 1 12 12 12 12 12 1 1 1 1 1 1 1 1 1 1 1 1 1 1 1 1 1 1 1 
1 1 1 1 1 1 1 1 1 1 1 1 1 1 1 1 12 12 12 12 12 1 1 1 1 1 1 1 1 1 1 1 1 1 1 1 1 1 1 1 
1 1 1 1 1 1 1 1 1 1 1 1 1 1 1 1 12 12 12 12 12 1 1 1 1 1 1 1 1 1 1 1 1 1 1 1 1 1 1 1 
