Connections;left:FORTREE CITY (0.4);right:ROUTE 121 (0.36);
Exits;ANCIENT TOMB (24.68);SCORCHED SLAB (24.73);
1 1 1 1 1 1 1 1 1 1 1 1 1 1 1 1 1 1 1 1 1 1 1 1 1 1 1 1 1 1 1 1 1 1 1 1 1 1 1 1 
1 1 1 1 1 1 1 1 1 12 12 12 1 1 1 12 12 12 12 12 12 1 1 1 1 1 1 1 1 1 1 1 1 1 1 1 1 1 1 1 
1 1 1 1 1 1 1 1 1 1 1 12 12 12 12 12 1 1 1 1 12 12 12 12 12 12 12 12 12 1 1 1 1 1 1 1 1 1 1 1 
1 1 1 1 1 1 1 1 1 1 1 1 1 1 1 1 1 1 1 12 12 12 12 12 12 12 12 1 12 12 12 12 12 1 1 1 1 1 1 1 
1 1 1 1 12 12 1 1 1 1 1 1 1 1 1 1 12 12 12 12 12 12 12 12 12 12 12 12 12 12 12 12 12 12 12 12 1 1 1 1 
12 12 12 12 12 12 12 12 12 12 12 12 12 12 12 12 12 12 12 12 12 12 12 12 12 12 12 12 12 12 12 12 12 12 12 12 12 12 1 1 
12 12 12 12 12 12 12 12 12 12 12 12 12 12 12 12 12 12 12 12 12 12 12 12 12 12 12 12 12 12 12 12 12 12 12 12 12 12 12 1 
12 12 12 12 12 12 12 12 12 12 12 12 12 12 12 12 12 12 12 12 12 12 12 12 12 12 12 12 12 12 12 12 12 12 12 12 12 12 12 1 
12 12 12 12 12 12 12 12 12 12 12 12 12 12 12 12 12 12 12 12 12 12 12 12 12 12 12 12 12 12 12 12 12 12 12 12 12 12 12 12 
12 12 12 12 1 1 1 12 12 12 12 12 12 12 12 12 12 12 12 1 12 12 12 12 12 12 12 12 12 12 12 12 12 12 12 12 12 12 12 12 
12 1 1 1 1 1 1 1 1 1 1 1 1 1 1 1 1 1 1 1 12 12 12 12 12 1 1 1 12 12 12 12 12 12 12 12 12 12 12 1 
1 1 1 1 1 1 1 1 1 1 1 1 1 1 1 1 1 1 1 1 12 1 1 1 1 12 12 12 12 12 12 12 12 12 12 12 12 12 1 1 
1 1 1 1 1 1 1 1 1 1 4 4 4 4 4 4 4 1 1 1 12 1 1 1 1 1 1 1 12 12 12 12 12 12 12 12 12 12 1 1 
1 1 1 1 1 1 1 1 1 1 4 4 4 4 4 4 4 12 12 12 12 12 12 1 1 1 1 1 12 12 12 12 12 12 12 12 12 1 1 1 
1 1 1 1 1 1 1 1 1 1 4 4 4 4 4 4 4 4 4 4 4 4 4 4 4 4 1 1 12 12 12 12 12 12 12 12 12 1 1 1 
1 1 1 1 1 12 12 0 16 16 60 60 60 60 60 60 60 60 60 60 60 60 60 60 60 60 16 16 0 12 12 12 12 12 12 12 1 1 1 1 
1 1 1 1 12 12 12 0 16 16 60 60 60 60 60 60 60 60 60 60 60 60 60 60 60 60 16 16 0 12 12 12 12 12 1 1 1 1 1 1 
1 1 1 1 12 12 12 12 1 1 4 4 4 4 4 4 4 4 4 4 4 4 4 4 4 4 1 1 12 12 12 12 12 1 1 1 1 1 1 1 
1 1 1 12 12 12 12 12 1 1 4 4 4 4 4 4 4 4 4 4 4 4 4 4 4 4 1 1 12 1 1 1 1 1 1 1 1 1 1 1 
1 1 1 12 12 12 12 12 1 1 4 4 4 4 4 4 4 4 4 4 4 4 4 4 4 4 1 1 1 1 1 1 1 1 1 1 1 1 1 1 
1 1 1 12 12 12 12 12 1 1 4 4 4 4 4 4 4 4 5 5 5 4 4 4 4 4 1 1 1 1 1 1 1 1 1 1 1 1 1 1 
1 1 1 12 12 12 12 12 1 1 1 1 4 4 4 4 4 5 5 5 5 5 4 4 4 4 1 1 1 1 1 1 1 1 1 1 1 1 1 1 
1 1 12 12 12 12 12 12 1 1 1 1 4 4 4 4 4 5 5 5 5 5 4 1 1 1 1 1 1 1 1 1 1 1 1 1 1 1 1 1 
1 1 12 12 12 12 12 12 1 1 1 1 4 4 4 4 4 5 5 4 5 5 1 1 1 1 1 1 1 1 1 1 1 1 1 1 1 1 1 1 
1 12 12 12 12 12 12 12 1 1 1 1 1 1 1 1 4 4 4 4 4 4 1 1 1 1 1 1 1 1 12 12 12 12 13 13 13 12 1 1 
1 12 12 12 12 12 12 12 12 1 1 1 1 1 1 1 1 1 1 1 1 1 1 1 1 1 1 1 1 1 1 12 12 12 12 12 12 12 1 1 
12 12 12 12 12 12 12 12 12 12 1 1 1 1 1 1 1 1 1 1 1 1 1 1 1 1 1 1 1 1 1 12 12 12 12 12 12 12 1 1 
12 12 12 12 12 12 12 12 12 12 12 12 1 1 1 1 1 1 1 1 1 1 1 1 1 1 1 1 1 1 1 1 12 12 12 12 12 1 1 1 
12 12 12 12 12 12 12 12 12 12 12 12 12 12 1 1 1 1 1 12 12 12 12 12 1 1 1 1 1 1 1 1 12 12 12 12 1 1 1 1 
1 12 12 12 12 12 12 12 12 12 12 12 12 12 12 12 12 12 12 12 12 12 12 12 12 12 12 12 12 12 1 1 1 1 12 12 1 1 1 1 
1 12 12 12 12 12 12 12 12 12 12 12 12 12 12 12 12 12 12 12 12 12 12 12 12 12 12 12 12 12 12 1 1 1 1 12 1 1 1 1 
1 1 12 12 12 12 12 12 12 12 12 12 12 1 1 12 12 12 12 12 12 12 12 12 12 12 12 12 12 12 12 12 1 1 1 12 1 1 1 1 
1 1 1 1 1 12 12 12 12 12 12 12 12 1 1 12 12 12 12 12 1 12 12 12 12 12 1 1 12 12 12 12 12 1 1 12 1 1 1 1 
1 1 1 1 1 1 1 12 12 12 12 12 12 12 12 12 12 12 12 1 1 1 12 12 12 1 1 1 12 12 12 12 12 12 12 12 1 1 1 1 
1 1 1 1 1 1 1 1 12 12 12 12 12 12 12 12 12 12 12 1 12 12 12 12 12 1 1 12 12 12 12 12 12 12 12 12 1 1 1 1 
1 1 1 1 1 1 1 1 1 1 12 12 12 12 1 1 12 12 12 12 12 12 12 12 12 12 12 12 12 12 12 12 12 12 12 12 1 1 1 1 
1 1 1 1 1 1 1 1 1 1 1 1 1 12 1 1 1 12 12 12 12 12 12 12 12 12 12 12 12 12 12 12 12 12 12 1 1 1 1 1 
1 1 1 1 1 1 1 1 1 1 1 1 1 12 12 12 1 12 12 12 12 12 12 12 12 12 12 12 12 12 12 12 12 12 12 1 1 1 1 1 
13 13 13 13 13 13 13 13 13 13 13 13 1 12 12 12 12 1 12 12 12 12 12 12 12 12 12 12 12 12 12 12 12 12 12 1 1 1 1 1 
1 1 1 1 1 1 12 12 1 1 1 1 12 13 1 12 12 12 1 12 12 12 12 12 12 12 12 12 12 12 12 12 12 12 12 1 1 1 1 1 
1 1 1 1 1 1 1 1 1 1 1 1 1 1 1 1 12 12 1 1 1 1 1 1 12 12 12 12 12 12 12 12 12 12 12 12 12 1 1 1 
1 1 1 1 1 1 1 1 1 1 1 1 1 1 1 1 12 12 1 1 1 1 1 1 12 12 12 12 12 12 12 12 12 12 12 12 12 1 1 1 
13 13 13 13 13 13 13 1 1 1 1 1 1 1 13 12 1 12 12 1 1 1 1 1 12 12 12 12 12 12 12 12 12 12 12 12 12 1 1 1 
1 1 1 1 1 1 1 1 12 12 12 13 12 1 1 12 1 1 12 12 12 12 12 12 12 12 12 12 12 12 12 12 12 12 12 12 12 12 1 1 
1 1 1 1 1 1 1 13 13 13 1 1 12 1 1 1 1 1 12 12 12 12 12 12 12 12 12 12 12 12 12 12 12 12 12 12 12 12 1 1 
1 1 1 1 1 1 1 1 1 1 1 1 1 1 1 1 1 1 12 12 12 12 12 12 12 12 12 12 12 12 12 12 12 12 12 12 12 12 1 1 
1 1 1 1 1 1 1 1 1 1 1 1 1 12 12 1 1 1 12 12 12 12 12 12 12 12 12 12 12 12 12 12 12 12 12 12 12 12 1 1 
1 1 1 1 1 1 1 1 1 12 12 12 13 13 1 1 1 1 12 12 12 12 12 12 12 12 12 12 12 12 12 12 12 12 12 12 12 12 1 1 
1 1 1 1 1 1 12 12 12 12 12 12 1 1 1 1 1 1 12 12 12 12 12 12 12 12 12 12 12 12 12 12 12 12 12 12 12 12 12 1 
1 1 1 12 12 12 12 12 12 12 12 12 12 1 1 1 1 1 12 12 12 12 12 12 12 12 12 12 12 12 12 12 12 12 12 12 12 12 12 1 
1 1 12 1 1 12 12 12 12 12 1 1 12 12 1 1 1 1 12 12 12 12 12 12 12 12 12 12 12 12 12 12 12 12 12 12 12 12 12 1 
1 12 12 1 1 12 12 12 12 12 1 1 12 12 1 1 1 1 12 12 12 12 12 12 12 12 12 12 12 12 12 12 12 12 12 12 12 12 12 1 
1 12 12 12 12 12 1 1 1 12 12 12 12 12 1 1 1 1 12 12 12 12 12 12 12 12 12 12 12 12 12 12 12 12 12 12 12 12 12 12 
1 12 12 12 12 1 1 1 1 1 12 12 12 12 1 1 1 1 12 12 12 12 12 12 12 12 12 12 12 12 12 12 12 12 12 12 12 12 12 12 
12 1 1 12 12 1 1 1 1 1 12 12 1 1 1 1 1 1 12 12 12 12 12 12 12 12 12 12 12 12 12 12 12 12 12 12 12 1 1 1 
12 1 1 12 12 1 1 0 1 1 12 12 1 1 1 1 1 1 12 12 12 12 12 12 12 12 12 12 12 12 12 12 12 12 12 12 12 12 12 12 
12 12 12 12 12 12 12 12 12 12 12 12 12 12 1 1 1 1 12 12 12 12 12 12 12 12 12 12 12 12 12 12 12 12 12 12 12 12 12 12 
12 12 12 12 12 12 12 12 12 12 12 12 12 12 1 1 1 1 12 12 12 12 12 12 12 12 12 12 12 12 12 12 12 12 12 12 12 12 12 12 
12 12 12 1 1 12 12 12 12 12 1 1 12 12 1 1 1 1 1 1 12 12 12 12 12 12 12 12 12 12 12 12 12 12 12 12 12 12 12 12 
12 12 12 1 1 12 12 12 12 12 1 1 12 12 1 1 1 1 1 1 1 1 1 1 12 12 12 12 12 12 12 12 12 12 12 12 12 12 12 12 
12 12 12 12 12 12 12 12 12 12 12 12 12 12 1 1 1 1 1 1 1 1 12 12 12 12 12 12 12 12 12 12 12 12 12 12 12 12 12 12 
12 12 12 12 12 12 12 12 12 12 12 12 12 12 1 1 1 1 1 20 20 1 12 12 12 12 12 12 12 12 12 12 12 12 13 13 13 13 13 12 
12 12 12 12 12 12 12 12 12 12 12 12 12 12 1 1 1 1 20 20 20 1 12 1 1 1 1 1 1 1 1 1 1 1 12 12 12 12 12 1 
1 12 12 12 12 12 12 12 12 12 12 12 12 12 1 1 1 1 20 20 1 1 12 1 12 12 12 12 12 12 12 1 1 1 1 12 12 12 12 1 
1 12 12 12 12 12 12 12 12 12 12 12 12 12 1 1 1 1 20 20 20 20 1 1 12 12 12 12 12 12 12 1 1 1 1 1 12 12 12 1 
1 1 1 12 12 12 12 12 12 12 1 1 12 1 1 1 1 1 20 20 20 1 1 1 4 4 4 4 4 4 4 1 1 1 1 1 12 12 12 1 
1 1 1 1 1 1 1 12 12 12 1 1 12 1 1 1 1 1 20 20 20 1 1 1 4 4 4 4 4 4 4 4 1 1 1 1 12 12 12 1 
1 1 1 1 1 1 1 1 12 12 1 1 12 12 12 12 1 1 20 20 20 0 16 16 60 60 60 60 60 60 60 60 16 16 0 12 12 12 12 1 
1 1 1 1 1 1 1 1 1 12 1 1 12 12 12 12 1 1 20 20 20 0 16 16 60 60 60 60 60 60 60 60 16 16 0 12 12 12 12 1 
1 1 1 1 1 1 1 1 1 1 1 1 12 12 12 12 1 1 20 20 20 20 0 1 4 4 4 4 4 4 4 4 1 0 12 12 12 12 1 1 
1 1 1 1 1 1 1 1 1 1 1 1 12 12 12 12 1 1 1 20 20 20 20 1 4 4 4 4 4 4 4 4 1 12 12 12 12 1 1 1 
1 1 1 1 1 1 1 1 1 1 1 1 12 12 12 12 1 1 1 1 20 20 20 1 4 4 4 4 4 4 4 4 1 12 12 12 1 1 1 1 
1 1 1 1 1 1 1 1 1 1 12 12 12 12 12 1 1 1 1 1 20 20 20 1 4 4 4 4 4 4 4 4 1 1 1 1 1 1 1 1 
1 1 1 1 1 1 1 1 1 12 12 12 12 12 12 1 1 1 1 20 20 20 20 1 4 4 4 4 4 4 4 4 1 1 1 1 1 1 1 1 
1 1 1 1 1 1 1 1 1 1 12 12 12 12 12 1 1 20 20 20 20 20 20 1 4 4 4 4 4 4 4 4 1 1 1 1 1 1 1 1 
1 1 1 1 1 1 1 1 1 12 12 12 12 12 12 1 1 20 20 20 20 20 20 1 4 4 4 4 4 4 4 4 1 1 1 1 1 1 1 1 
1 1 1 1 1 1 1 1 12 12 12 12 12 12 1 1 1 20 20 20 20 1 20 1 4 4 4 4 4 4 4 4 1 1 1 1 1 1 1 1 
1 1 1 1 12 12 12 12 12 12 12 12 12 12 1 1 1 20 20 20 20 1 0 12 12 4 4 4 4 4 1 1 1 1 1 1 1 1 1 1 
1 1 1 12 12 12 12 12 12 12 12 12 12 12 1 1 20 20 20 20 20 1 12 12 12 4 4 4 4 1 1 1 1 1 1 1 1 1 1 1 
1 1 12 12 13 13 13 13 12 12 12 12 12 12 1 1 20 20 20 20 20 1 12 12 12 12 12 12 12 1 1 1 1 1 1 1 1 1 1 1 
4 4 4 4 4 4 4 4 4 12 12 12 12 12 1 1 20 20 20 20 20 1 12 12 12 12 12 12 12 1 1 1 1 1 1 1 1 1 1 1 
4 4 4 4 4 4 4 4 4 12 12 12 12 12 1 1 20 20 20 20 20 1 12 12 12 12 12 12 12 1 1 1 1 1 1 1 1 1 1 1 
4 4 4 4 4 4 4 4 4 1 1 12 12 12 1 1 20 20 20 20 20 20 20 20 1 1 1 1 1 1 1 1 1 1 1 1 1 1 1 1 
4 4 4 4 4 4 4 4 4 1 1 12 12 12 1 1 20 20 20 20 20 20 20 20 20 20 1 1 1 1 1 1 1 1 1 1 1 1 1 1 
4 4 4 4 4 4 4 4 4 1 1 12 12 12 1 1 20 20 20 20 20 20 20 20 20 20 20 20 1 1 20 1 1 1 1 1 1 1 1 1 
4 4 4 4 4 4 4 4 4 1 1 12 12 12 1 1 20 20 20 20 20 20 20 20 20 20 20 20 1 1 1 1 1 1 1 1 1 1 1 1 
12 12 4 4 4 4 4 4 4 1 1 1 0 1 1 1 20 20 20 20 20 20 20 20 20 20 20 20 20 20 20 20 1 1 1 1 1 1 1 12 
12 12 12 12 4 4 4 4 4 1 1 1 0 1 1 1 20 20 20 20 20 20 20 20 20 20 20 20 20 20 20 20 1 1 0 12 12 12 12 12 
1 1 12 12 12 12 12 12 12 12 1 1 20 20 20 20 20 20 20 20 20 20 20 20 20 20 20 20 20 20 20 20 20 20 0 12 12 12 1 12 
1 1 1 1 12 12 12 12 12 12 1 1 20 20 20 20 20 20 20 20 20 20 20 20 20 20 20 20 20 20 20 20 20 20 0 12 12 12 12 12 
1 1 1 1 1 1 1 1 1 1 1 1 20 20 20 20 20 20 20 20 20 20 20 20 20 20 20 20 20 20 20 20 20 20 0 12 12 12 12 12 
1 1 1 1 1 1 1 1 1 1 1 1 20 20 20 20 20 20 20 20 20 20 20 20 20 20 20 20 20 20 20 20 20 20 0 12 12 12 12 12 
1 1 1 1 1 1 1 1 20 21 21 21 20 20 20 20 20 20 20 20 20 20 20 20 20 20 20 20 20 1 1 1 1 20 0 12 12 12 12 12 
1 1 1 1 1 1 1 1 20 20 20 20 20 20 20 20 1 1 20 20 20 20 20 20 20 1 1 1 1 1 1 1 1 1 1 1 1 12 12 12 
1 1 1 1 1 1 1 1 20 20 20 20 20 1 1 1 1 1 1 20 20 20 20 1 1 1 1 1 1 1 1 1 4 4 4 4 1 1 1 1 
1 1 1 1 1 1 1 1 1 1 1 1 1 1 1 1 1 1 1 1 1 1 1 1 1 1 1 1 1 1 1 4 4 4 4 4 4 4 4 4 
1 1 1 1 12 1 1 12 1 1 1 1 1 1 1 5 1 1 1 1 1 1 4 4 4 4 4 4 4 4 4 4 4 4 4 4 4 4 4 4 
1 1 12 12 1 1 1 1 1 1 1 1 1 5 1 5 4 4 4 4 4 4 4 4 4 4 4 4 4 4 4 4 4 4 4 4 4 4 4 4 
1 1 1 1 1 1 1 1 1 1 1 5 1 5 4 4 4 4 4 4 4 4 4 4 4 4 4 4 4 4 4 4 4 4 4 4 4 4 4 4 
1 1 1 1 1 1 1 1 1 1 5 5 4 4 4 4 4 4 4 4 4 4 4 4 4 4 4 4 4 4 4 4 4 4 4 4 4 4 4 20 
