connections=[
		],
events={
	
		'exits':[{'name':'ROUTE 124 (0.39)','x':3,'y':8},{'name':'ROUTE 124 (0.39)','x':4,'y':8},		],
	
		'NPCs':[
			{'is_trainer':0,'b1':9,'b2':0,'sprite':'66','x':5,'y':4},
		],
	
		'signs':[
			{'x':7,'y':1},
		],
	
		'triggers':[
		],

},
partial_map=[
	[1, 1, 1, 1, 1, 1, 1, 1, 1, 1, ],
	[1, 1, 1, 1, 1, 1, 1, 1, 1, 12, ],
	[12, 12, 12, 12, 12, 12, 12, 12, 12, 1, ],
	[12, 12, 12, 12, 12, 12, 12, 12, 12, 12, ],
	[12, 0, 12, 13, 13, 0, 0, 0, 12, 12, ],
	[12, 0, 12, 13, 13, 0, 0, 0, 12, 12, ],
	[12, 12, 12, 12, 12, 12, 12, 0, 12, 12, ],
	[12, 12, 12, 12, 12, 12, 12, 12, 12, 12, ],
	[12, 12, 12, 0, 0, 12, 12, 12, 12, 13, ],
]
