Connections;up:SLATEPORT CITY (0.1);left:ROUTE 108 (0.23);
Exits;ROUTE 109 (28.0);
1 1 4 4 4 4 4 4 12 12 12 12 12 12 12 12 12 12 12 12 12 12 12 12 12 12 12 12 12 12 12 12 12 12 12 12 4 4 1 1 
1 1 4 4 4 4 4 4 12 12 12 12 12 12 12 12 12 12 12 12 12 12 12 12 12 12 12 12 12 12 12 12 12 12 12 12 4 4 1 1 
4 1 1 4 4 4 4 4 4 12 12 12 12 12 12 12 12 12 12 12 12 12 12 12 12 12 12 12 12 12 12 12 12 12 12 4 4 4 1 1 
4 1 1 4 4 4 4 4 4 12 1 1 1 1 1 12 12 12 12 12 12 12 12 12 12 12 12 12 12 12 12 12 12 12 12 4 4 4 1 1 
4 4 1 1 4 4 4 4 4 12 1 1 1 1 1 12 12 12 12 12 12 12 12 12 12 12 12 12 12 12 12 12 12 12 12 4 4 4 1 1 
4 4 1 1 4 4 4 4 4 12 1 1 0 1 1 1 12 12 12 12 12 12 12 12 12 12 12 12 12 12 12 12 12 12 12 4 4 4 1 1 
4 4 1 1 4 4 4 4 4 12 12 12 12 12 12 12 12 12 12 12 12 12 12 12 12 12 12 12 12 12 12 12 12 12 4 4 4 4 1 1 
4 4 1 1 4 4 4 4 4 12 12 12 12 12 12 12 12 12 12 12 12 12 12 12 12 12 12 12 12 12 12 12 12 12 4 4 4 1 1 4 
4 1 1 4 4 4 4 4 4 12 12 12 12 12 12 12 12 12 12 12 12 12 12 12 12 12 12 12 12 12 12 12 12 12 4 4 4 1 1 4 
4 1 1 4 4 4 4 4 4 12 12 12 12 12 12 12 0 16 0 12 12 12 0 16 16 0 12 12 12 12 12 12 12 12 4 4 1 1 4 4 
4 4 4 1 1 4 4 4 4 12 12 12 12 0 16 16 0 16 0 12 12 12 0 16 16 0 12 12 12 13 12 12 12 4 4 4 1 1 1 1 
4 4 4 1 1 4 4 4 4 12 12 12 12 0 16 16 0 0 12 12 12 12 12 0 0 12 12 12 12 12 12 12 12 4 4 4 4 4 1 1 
4 4 4 4 1 1 4 4 4 4 12 0 16 0 0 0 12 12 12 12 12 12 12 12 12 12 12 12 12 12 12 12 12 4 4 4 4 1 1 4 
4 4 1 1 1 1 4 4 4 4 12 0 16 0 12 12 12 12 12 12 12 12 12 12 12 12 12 12 12 12 12 12 12 4 4 4 4 1 1 4 
4 4 1 5 1 4 4 4 4 4 4 12 0 12 12 12 12 12 12 0 16 16 16 16 0 12 12 0 12 12 12 12 4 4 4 4 4 4 1 1 
4 4 1 1 5 4 4 4 4 4 4 12 12 12 12 12 12 0 16 0 16 16 16 16 0 12 12 12 12 12 12 12 4 4 4 4 4 4 1 1 
4 4 4 4 1 1 4 4 4 4 4 12 12 12 12 12 12 0 16 0 0 0 0 0 12 12 0 12 12 12 12 12 4 4 4 4 4 1 1 4 
4 4 4 4 1 1 4 4 4 4 4 4 16 0 12 12 12 12 0 12 12 12 12 12 12 12 12 12 12 12 4 4 4 4 4 4 4 1 1 4 
4 4 4 1 1 4 4 4 4 4 4 4 16 0 12 0 16 16 0 12 12 12 0 16 0 12 12 12 12 12 4 4 4 4 4 4 1 1 4 4 
4 4 4 1 1 4 4 4 4 4 4 4 4 12 12 0 16 16 0 12 12 12 0 16 0 12 12 12 12 4 4 4 4 4 4 4 1 1 4 4 
4 4 4 1 1 4 4 4 4 4 4 4 4 12 12 12 0 0 12 12 12 12 12 0 12 12 12 12 12 4 4 4 4 4 4 4 4 1 1 4 
4 4 4 1 1 1 1 4 4 4 4 4 4 4 4 4 12 12 12 12 12 12 12 12 12 12 12 4 4 4 4 4 4 4 4 4 4 1 1 4 
4 4 4 4 4 1 1 4 4 4 4 4 4 4 4 4 12 12 12 12 12 12 12 12 12 12 12 4 4 4 4 4 4 4 4 4 4 1 5 1 
4 4 4 4 4 4 1 1 4 4 4 4 4 4 4 4 12 12 12 12 12 12 12 12 12 4 4 4 4 4 4 4 4 4 4 4 1 5 0 1 
4 4 4 4 4 4 1 1 4 4 4 4 4 4 4 4 4 4 4 12 12 12 12 4 4 4 4 4 4 4 4 4 4 4 4 4 1 0 1 5 
4 4 4 4 4 1 1 4 4 4 4 4 4 4 4 4 4 4 4 4 4 4 4 4 4 4 4 4 4 4 4 4 4 4 4 4 1 0 1 4 
4 4 4 4 4 1 1 4 4 4 4 4 4 4 4 4 4 4 4 4 4 4 4 4 4 4 4 4 4 4 4 4 4 4 1 1 1 1 5 4 
4 4 4 4 1 5 1 4 4 4 4 4 4 4 4 4 4 4 4 4 4 4 4 4 4 4 4 4 4 4 4 4 4 4 1 1 4 4 4 4 
4 4 4 1 5 0 1 1 1 4 4 4 4 4 4 4 4 4 4 4 4 4 4 4 4 4 4 12 12 4 4 4 4 4 4 4 1 1 4 4 
4 4 4 1 0 0 1 1 1 4 4 4 4 4 4 4 4 4 4 4 4 4 4 4 4 4 12 12 12 12 12 4 4 4 4 4 1 1 4 4 
4 4 4 1 0 1 5 4 4 4 4 4 4 4 4 4 4 4 4 4 4 4 4 4 4 12 12 12 12 12 12 12 12 4 4 1 1 4 4 4 
4 4 4 1 1 5 4 4 4 4 4 4 4 4 4 4 4 4 4 4 4 4 4 4 4 12 12 12 12 12 12 12 12 4 4 1 1 4 4 4 
4 4 1 1 4 4 1 1 4 4 4 4 4 4 4 4 4 4 4 4 4 4 4 4 4 12 12 12 12 12 12 12 12 4 4 4 1 1 4 4 
4 4 1 1 4 4 1 1 1 1 4 4 4 4 4 4 4 4 4 4 4 4 4 4 4 12 12 12 12 12 12 12 4 4 4 4 1 1 4 4 
4 4 4 4 4 4 4 4 1 1 4 4 4 4 4 4 4 4 4 4 4 4 4 4 4 4 4 12 12 12 4 4 4 4 4 1 1 4 4 4 
4 4 4 4 4 4 1 5 1 4 4 4 4 4 4 4 4 4 4 4 4 4 4 4 4 4 4 4 4 4 4 4 4 4 4 1 1 4 4 4 
4 4 4 4 1 1 1 0 1 4 4 4 4 4 4 4 4 4 4 4 4 4 4 4 4 4 4 4 4 4 4 4 4 4 1 1 4 4 4 4 
4 4 4 4 1 1 1 1 5 4 4 4 4 4 4 4 4 4 4 4 4 4 4 4 4 4 4 4 4 4 4 4 4 4 1 1 4 4 4 4 
4 4 4 1 1 4 4 4 4 4 4 4 4 4 4 4 4 4 4 4 4 4 4 4 4 4 4 4 4 4 4 4 4 1 1 4 4 4 4 4 
4 4 4 1 1 4 4 4 4 4 4 4 4 4 4 4 4 4 4 4 4 4 4 4 4 4 4 4 4 4 4 4 4 1 1 4 4 4 4 4 
4 4 1 1 4 4 4 4 12 12 4 4 4 4 4 4 4 4 4 4 4 4 4 4 4 4 4 4 4 4 4 1 1 4 4 5 5 4 4 4 
1 1 1 1 4 4 4 12 12 12 4 4 4 4 4 4 4 4 4 4 4 4 4 4 4 4 4 4 4 4 4 1 1 4 4 5 5 4 4 4 
1 1 4 4 4 4 4 12 12 12 4 4 4 4 4 4 4 4 4 4 4 4 4 4 4 4 4 12 12 4 4 4 1 1 4 4 4 4 4 4 
4 4 5 5 4 4 4 12 12 4 4 4 4 4 4 4 4 4 4 4 4 4 4 4 4 4 12 12 12 4 4 4 1 1 4 4 4 4 4 4 
4 4 5 5 4 4 4 4 4 4 4 4 4 4 4 4 4 4 4 4 4 4 4 4 4 4 12 12 12 12 4 4 4 1 1 4 4 4 4 4 
4 4 4 4 4 4 4 4 4 4 4 4 4 4 4 4 4 4 4 4 4 4 4 4 4 12 12 12 12 12 4 4 4 1 1 4 4 4 4 4 
4 4 4 4 4 4 4 4 4 4 4 4 4 4 4 4 4 4 4 4 4 4 4 4 4 12 12 12 12 12 4 4 4 4 1 1 4 4 4 4 
4 4 4 4 4 4 4 4 4 4 4 4 4 4 4 4 4 4 4 4 4 4 4 4 4 12 12 12 12 4 4 4 4 4 1 1 4 4 4 4 
4 4 4 4 4 4 4 4 4 4 4 4 4 4 4 4 4 4 4 4 4 4 4 4 4 4 4 4 4 4 4 4 4 1 1 4 4 4 4 4 
4 4 4 4 4 4 4 4 4 4 4 4 4 4 4 4 4 4 4 4 4 4 4 4 4 4 4 4 4 4 4 4 4 1 1 4 4 4 4 4 
4 4 4 4 4 4 4 4 4 4 4 4 4 4 4 4 4 4 4 4 4 4 4 4 4 4 4 4 4 4 4 4 4 4 1 1 4 4 4 4 
4 4 4 4 4 4 4 4 4 4 4 4 4 4 4 4 12 12 12 12 12 4 4 4 4 4 4 4 4 4 4 4 4 4 1 1 4 4 4 4 
4 4 4 4 4 4 4 4 4 4 4 4 4 4 4 4 12 12 12 12 12 4 4 4 4 4 4 4 4 4 4 4 4 1 1 4 4 4 4 4 
4 4 4 4 4 4 4 4 4 4 4 4 4 4 4 4 12 0 16 0 12 4 4 4 4 4 4 4 4 4 4 4 4 1 1 4 4 4 4 4 
4 4 1 1 1 1 4 4 1 1 4 4 4 4 4 4 12 0 16 0 12 4 4 4 4 4 4 4 4 4 4 4 4 1 5 1 4 4 4 4 
1 1 1 1 1 1 4 4 1 1 4 4 4 4 4 4 12 12 0 12 12 12 4 4 1 1 4 4 4 4 4 4 1 5 0 1 4 4 4 4 
1 1 4 4 4 1 1 1 5 1 4 4 4 4 4 12 12 12 12 0 16 0 12 4 1 1 4 4 4 4 1 1 1 0 1 5 4 4 4 4 
4 4 4 4 4 1 1 1 0 1 4 4 4 4 4 12 12 12 12 0 16 0 12 4 1 1 1 1 4 4 1 1 1 1 5 4 4 4 4 4 
4 4 4 4 4 4 4 1 1 5 4 4 4 4 4 4 4 4 12 12 0 12 4 4 1 1 1 1 1 1 4 4 4 4 4 4 4 4 4 4 
4 4 4 4 4 4 4 4 4 1 1 4 4 4 1 1 4 4 4 4 12 4 4 1 1 4 4 4 1 1 4 4 4 4 4 4 4 4 4 4 
4 4 4 4 4 4 4 4 4 1 1 5 5 4 1 1 4 4 4 4 4 4 4 1 1 4 4 4 4 4 4 4 4 4 4 4 4 4 4 4 
4 4 4 4 4 4 4 4 4 4 4 1 5 1 1 1 1 1 1 1 1 1 1 4 4 4 4 4 4 4 4 4 4 4 4 4 4 4 4 4 
4 4 4 4 4 4 4 4 4 4 4 4 4 1 1 1 1 1 1 1 1 1 1 4 4 4 4 4 4 4 4 4 4 4 4 4 4 4 4 4 
