connections=[
			{'left':'ROUTE 107 (0.22)'},
			{'right':'ROUTE 109 (0.24)'},
		],
events={
	
		'exits':[{'name':'ABANDONED SHIP (24.54)','x':29,'y':6},		],
	
		'NPCs':[
			{'is_trainer':1,'b1':45,'b2':0,'sprite':'42','x':52,'y':13},
			{'is_trainer':1,'b1':13,'b2':0,'sprite':'43','x':35,'y':12},
			{'is_trainer':1,'b1':24,'b2':0,'sprite':'42','x':13,'y':13},
			{'is_trainer':1,'b1':20,'b2':0,'sprite':'43','x':8,'y':7},
			{'is_trainer':1,'b1':10,'b2':0,'sprite':'34','x':41,'y':5},
			{'is_trainer':1,'b1':9,'b2':0,'sprite':'49','x':43,'y':5},
			{'is_trainer':0,'b1':1,'b2':0,'sprite':'59','x':42,'y':4},
		],
	
		'signs':[
			{'x':38,'y':14},
		],
	
		'triggers':[
		],

},
partial_map=[
	[4, 4, 4, 4, 4, 4, 4, 4, 4, 4, 4, 4, 4, 4, 4, 4, 1, 1, 4, 4, 4, 12, 12, 12, 12, 12, 12, 12, 12, 12, 12, 12, 12, 4, 4, 4, 4, 4, 4, 4, 4, 4, 4, 4, 4, 4, 4, 1, 1, 4, 4, 4, 4, 4, 4, 4, 4, 4, 4, 4, ],
	[1, 1, 4, 4, 4, 4, 4, 4, 4, 4, 4, 4, 4, 4, 4, 4, 1, 1, 4, 4, 12, 12, 13, 12, 12, 13, 13, 12, 13, 13, 13, 12, 12, 1, 1, 4, 4, 4, 4, 4, 4, 4, 4, 4, 4, 4, 4, 1, 1, 4, 4, 4, 4, 4, 4, 4, 4, 4, 1, 1, ],
	[1, 1, 4, 12, 12, 4, 4, 1, 1, 4, 4, 4, 4, 4, 4, 4, 4, 4, 1, 1, 13, 13, 12, 13, 13, 13, 13, 13, 12, 13, 13, 13, 13, 5, 1, 4, 4, 4, 12, 12, 12, 12, 12, 12, 12, 4, 4, 1, 1, 4, 4, 1, 1, 4, 1, 1, 1, 1, 1, 1, ],
	[4, 1, 1, 13, 13, 1, 1, 1, 1, 4, 12, 12, 4, 4, 1, 1, 4, 4, 1, 1, 13, 13, 12, 12, 12, 13, 13, 12, 12, 12, 12, 12, 13, 4, 4, 1, 1, 1, 1, 13, 13, 12, 13, 12, 13, 1, 1, 1, 1, 4, 4, 1, 1, 4, 1, 1, 1, 1, 4, 4, ],
	[4, 1, 1, 13, 13, 5, 1, 4, 1, 1, 13, 13, 1, 1, 1, 1, 1, 1, 4, 4, 4, 4, 4, 4, 4, 13, 13, 13, 1, 1, 1, 13, 5, 4, 4, 1, 1, 1, 1, 13, 13, 13, 12, 13, 12, 1, 1, 4, 4, 1, 1, 4, 1, 1, 4, 4, 4, 4, 4, 4, ],
	[4, 4, 4, 4, 4, 4, 4, 4, 1, 1, 13, 13, 5, 1, 4, 4, 1, 1, 4, 4, 4, 4, 4, 4, 4, 4, 12, 5, 1, 1, 1, 5, 5, 4, 4, 4, 4, 4, 4, 4, 12, 12, 12, 12, 4, 4, 4, 4, 4, 1, 1, 4, 1, 1, 4, 4, 4, 4, 4, 4, ],
	[4, 4, 4, 4, 4, 4, 4, 4, 4, 4, 4, 4, 4, 4, 4, 4, 4, 4, 4, 4, 4, 4, 4, 4, 4, 4, 4, 4, 12, 12, 12, 4, 4, 4, 4, 4, 4, 4, 4, 4, 4, 4, 4, 4, 4, 4, 4, 4, 4, 4, 4, 4, 4, 4, 4, 4, 4, 4, 4, 4, ],
	[4, 4, 4, 4, 4, 4, 4, 4, 4, 4, 4, 4, 4, 4, 4, 4, 4, 4, 4, 4, 4, 4, 4, 4, 4, 4, 4, 4, 4, 4, 4, 4, 4, 4, 4, 4, 4, 4, 4, 4, 4, 4, 4, 4, 4, 4, 4, 4, 4, 4, 4, 4, 4, 4, 4, 4, 4, 4, 4, 4, ],
	[4, 4, 4, 4, 4, 4, 4, 4, 4, 4, 4, 4, 4, 4, 4, 4, 4, 4, 4, 4, 4, 4, 4, 4, 4, 4, 4, 4, 4, 4, 4, 4, 4, 4, 4, 4, 4, 4, 4, 4, 4, 4, 4, 4, 4, 4, 4, 4, 4, 4, 4, 4, 4, 4, 4, 4, 4, 4, 4, 4, ],
	[4, 4, 4, 4, 4, 4, 4, 4, 4, 4, 4, 4, 4, 4, 4, 4, 4, 4, 4, 4, 4, 4, 4, 4, 4, 4, 4, 4, 4, 4, 4, 4, 4, 4, 4, 4, 4, 4, 4, 4, 4, 4, 4, 4, 4, 4, 4, 4, 4, 4, 4, 4, 4, 4, 4, 4, 4, 4, 4, 4, ],
	[4, 4, 4, 4, 4, 4, 4, 4, 4, 4, 4, 4, 4, 4, 4, 4, 4, 4, 4, 4, 4, 4, 4, 4, 4, 4, 4, 4, 4, 4, 4, 4, 4, 4, 4, 4, 4, 4, 4, 4, 4, 4, 4, 4, 4, 4, 4, 4, 4, 4, 4, 4, 4, 4, 4, 4, 4, 4, 4, 4, ],
	[4, 4, 4, 4, 4, 4, 4, 4, 4, 4, 4, 4, 4, 4, 4, 4, 4, 4, 4, 4, 4, 4, 4, 4, 4, 4, 4, 4, 4, 4, 4, 4, 4, 4, 4, 4, 4, 4, 4, 4, 4, 4, 4, 4, 4, 4, 4, 4, 4, 4, 4, 4, 4, 4, 4, 4, 4, 4, 4, 4, ],
	[4, 4, 4, 4, 4, 4, 4, 4, 4, 4, 4, 4, 4, 4, 4, 4, 4, 4, 4, 4, 4, 4, 4, 4, 4, 1, 1, 4, 4, 4, 4, 4, 4, 4, 4, 4, 4, 4, 4, 4, 4, 1, 1, 4, 4, 12, 12, 4, 4, 4, 4, 4, 4, 4, 4, 4, 4, 4, 4, 4, ],
	[4, 4, 4, 1, 1, 4, 4, 4, 4, 4, 4, 4, 4, 4, 4, 4, 4, 4, 4, 4, 4, 4, 4, 4, 4, 1, 1, 4, 4, 4, 4, 4, 4, 4, 4, 4, 4, 12, 12, 4, 4, 1, 1, 4, 12, 13, 12, 12, 4, 4, 4, 4, 4, 4, 4, 4, 4, 4, 4, 4, ],
	[4, 4, 4, 1, 1, 4, 4, 4, 4, 4, 4, 4, 4, 4, 4, 4, 4, 4, 4, 4, 12, 12, 12, 4, 4, 4, 4, 4, 1, 1, 4, 4, 1, 1, 4, 4, 4, 4, 13, 4, 4, 4, 4, 4, 12, 13, 12, 12, 4, 4, 4, 4, 12, 12, 4, 4, 4, 4, 4, 4, ],
	[4, 1, 1, 4, 4, 1, 1, 1, 1, 4, 4, 4, 4, 4, 4, 12, 12, 4, 4, 4, 4, 13, 12, 4, 4, 4, 1, 1, 1, 1, 1, 1, 1, 1, 4, 4, 4, 4, 4, 4, 1, 1, 4, 4, 4, 4, 4, 4, 4, 4, 1, 1, 13, 13, 1, 1, 4, 4, 4, 4, ],
	[4, 1, 1, 4, 4, 1, 1, 1, 1, 1, 1, 4, 4, 1, 1, 13, 13, 1, 1, 4, 4, 4, 4, 4, 1, 1, 1, 1, 4, 4, 1, 1, 4, 1, 1, 4, 4, 1, 1, 4, 1, 1, 1, 1, 4, 4, 1, 1, 1, 1, 1, 1, 13, 13, 5, 1, 4, 4, 4, 4, ],
	[1, 1, 4, 4, 4, 4, 4, 4, 4, 1, 1, 1, 1, 1, 1, 13, 13, 5, 1, 4, 1, 1, 1, 1, 1, 1, 4, 4, 4, 4, 4, 4, 4, 1, 1, 1, 1, 1, 1, 1, 1, 4, 1, 1, 1, 1, 1, 1, 1, 1, 4, 4, 4, 4, 4, 4, 1, 1, 1, 1, ],
	[1, 1, 4, 4, 4, 4, 4, 4, 4, 4, 4, 1, 1, 4, 4, 4, 4, 4, 1, 1, 1, 1, 1, 1, 4, 4, 4, 1, 1, 4, 4, 4, 4, 4, 4, 1, 1, 4, 4, 1, 1, 4, 4, 4, 1, 1, 4, 4, 4, 4, 4, 1, 1, 4, 4, 4, 1, 1, 1, 1, ],
	[4, 4, 4, 4, 4, 4, 4, 4, 4, 4, 4, 4, 4, 4, 4, 4, 4, 4, 1, 1, 4, 4, 4, 4, 4, 4, 4, 1, 1, 4, 4, 4, 4, 4, 4, 4, 4, 4, 4, 4, 4, 4, 4, 4, 4, 4, 4, 4, 4, 4, 4, 1, 1, 4, 4, 4, 4, 4, 4, 4, ],
]
