connections=[
		],
events={
	
		'exits':[{'name':'ROUTE 110 (29.0)','x':0,'y':21},{'name':'ROUTE 110 (29.0)','x':1,'y':21},{'name':'ROUTE 110 (29.1)','x':13,'y':1},		],
	
		'NPCs':[
			{'is_trainer':1,'b1':8,'b2':0,'sprite':'14','x':2,'y':2},
			{'is_trainer':1,'b1':9,'b2':0,'sprite':'14','x':14,'y':7},
			{'is_trainer':1,'b1':10,'b2':0,'sprite':'44','x':2,'y':14},
			{'is_trainer':0,'b1':1,'b2':0,'sprite':'59','x':2,'y':5},
			{'is_trainer':0,'b1':1,'b2':0,'sprite':'87','x':13,'y':3},
			{'is_trainer':0,'b1':1,'b2':0,'sprite':'87','x':12,'y':5},
			{'is_trainer':0,'b1':1,'b2':0,'sprite':'87','x':5,'y':16},
			{'is_trainer':0,'b1':1,'b2':0,'sprite':'87','x':4,'y':6},
			{'is_trainer':0,'b1':1,'b2':0,'sprite':'87','x':12,'y':2},
			{'is_trainer':0,'b1':1,'b2':0,'sprite':'87','x':5,'y':7},
			{'is_trainer':0,'b1':1,'b2':0,'sprite':'87','x':9,'y':3},
			{'is_trainer':0,'b1':1,'b2':0,'sprite':'87','x':10,'y':12},
			{'is_trainer':0,'b1':1,'b2':0,'sprite':'87','x':14,'y':2},
			{'is_trainer':0,'b1':1,'b2':0,'sprite':'87','x':10,'y':15},
		],
	
		'signs':[
			{'x':14,'y':13},
		],
	
		'triggers':[
		],

},
partial_map=[
	[1, 1, 1, 1, 1, 1, 1, 1, 1, 1, 1, 1, 1, 1, 1, ],
	[1, 1, 1, 1, 1, 1, 1, 1, 1, 1, 1, 1, 1, 13, 1, ],
	[12, 12, 12, 12, 1, 1, 12, 12, 12, 12, 12, 1, 12, 12, 12, ],
	[12, 12, 12, 12, 12, 1, 12, 12, 12, 12, 1, 1, 12, 12, 12, ],
	[12, 12, 1, 1, 12, 1, 1, 12, 1, 12, 1, 12, 12, 12, 12, ],
	[12, 12, 12, 1, 12, 12, 12, 12, 1, 12, 1, 12, 12, 1, 1, ],
	[12, 12, 12, 1, 12, 12, 12, 12, 1, 12, 1, 1, 12, 1, 12, ],
	[1, 1, 1, 12, 12, 12, 12, 12, 1, 12, 12, 12, 12, 12, 12, ],
	[12, 12, 12, 12, 12, 1, 12, 12, 1, 12, 12, 12, 12, 12, 12, ],
	[12, 12, 12, 12, 12, 1, 12, 12, 12, 1, 1, 1, 1, 1, 1, ],
	[12, 12, 12, 12, 12, 1, 12, 12, 12, 12, 12, 12, 12, 12, 12, ],
	[12, 12, 1, 1, 1, 1, 1, 1, 1, 1, 12, 12, 12, 12, 12, ],
	[12, 12, 1, 12, 12, 12, 12, 1, 12, 12, 12, 12, 1, 1, 1, ],
	[12, 1, 1, 12, 12, 1, 12, 12, 12, 1, 12, 12, 1, 12, 1, ],
	[12, 1, 12, 12, 12, 1, 1, 1, 1, 1, 12, 1, 1, 12, 12, ],
	[12, 1, 12, 12, 12, 1, 12, 12, 12, 12, 12, 12, 1, 12, 12, ],
	[12, 1, 1, 1, 12, 12, 12, 12, 12, 1, 12, 12, 12, 12, 12, ],
	[12, 1, 12, 12, 12, 1, 12, 12, 12, 12, 12, 12, 12, 12, 12, ],
	[12, 1, 1, 1, 1, 1, 1, 1, 1, 1, 1, 1, 1, 1, 1, ],
	[12, 12, 12, 12, 12, 12, 12, 12, 12, 12, 12, 12, 12, 12, 12, ],
	[12, 12, 12, 12, 12, 12, 12, 12, 12, 12, 12, 12, 12, 12, 12, ],
	[12, 12, 12, 12, 12, 12, 12, 12, 12, 12, 12, 12, 12, 12, 12, ],
]
