Connections;left:ROUTE 107 (0.22);right:ROUTE 109 (0.24);
Exits;ABANDONED SHIP (24.54);
4 4 4 4 4 4 4 4 4 4 4 4 4 4 4 4 1 1 4 4 4 12 12 12 12 12 12 12 12 12 12 12 12 4 4 4 4 4 4 4 4 4 4 4 4 4 4 1 1 4 4 4 4 4 4 4 4 4 4 4 
1 1 4 4 4 4 4 4 4 4 4 4 4 4 4 4 1 1 4 4 12 12 13 12 12 13 13 12 13 13 13 12 12 1 1 4 4 4 4 4 4 4 4 4 4 4 4 1 1 4 4 4 4 4 4 4 4 4 1 1 
1 1 4 12 12 4 4 1 1 4 4 4 4 4 4 4 4 4 1 1 13 13 12 13 13 13 13 13 12 13 13 13 13 5 1 4 4 4 12 12 12 12 12 12 12 4 4 1 1 4 4 1 1 4 1 1 1 1 1 1 
4 1 1 13 13 1 1 1 1 4 12 12 4 4 1 1 4 4 1 1 13 13 12 12 12 13 13 12 12 12 12 12 13 4 4 1 1 1 1 13 13 12 13 12 13 1 1 1 1 4 4 1 1 4 1 1 1 1 4 4 
4 1 1 13 13 5 1 4 1 1 13 13 1 1 1 1 1 1 4 4 4 4 4 4 4 13 13 13 1 1 1 13 5 4 4 1 1 1 1 13 13 13 12 13 12 1 1 4 4 1 1 4 1 1 4 4 4 4 4 4 
4 4 4 4 4 4 4 4 1 1 13 13 5 1 4 4 1 1 4 4 4 4 4 4 4 4 12 5 1 1 1 5 5 4 4 4 4 4 4 4 12 12 12 12 4 4 4 4 4 1 1 4 1 1 4 4 4 4 4 4 
4 4 4 4 4 4 4 4 4 4 4 4 4 4 4 4 4 4 4 4 4 4 4 4 4 4 4 4 12 12 12 4 4 4 4 4 4 4 4 4 4 4 4 4 4 4 4 4 4 4 4 4 4 4 4 4 4 4 4 4 
4 4 4 4 4 4 4 4 4 4 4 4 4 4 4 4 4 4 4 4 4 4 4 4 4 4 4 4 4 4 4 4 4 4 4 4 4 4 4 4 4 4 4 4 4 4 4 4 4 4 4 4 4 4 4 4 4 4 4 4 
4 4 4 4 4 4 4 4 4 4 4 4 4 4 4 4 4 4 4 4 4 4 4 4 4 4 4 4 4 4 4 4 4 4 4 4 4 4 4 4 4 4 4 4 4 4 4 4 4 4 4 4 4 4 4 4 4 4 4 4 
4 4 4 4 4 4 4 4 4 4 4 4 4 4 4 4 4 4 4 4 4 4 4 4 4 4 4 4 4 4 4 4 4 4 4 4 4 4 4 4 4 4 4 4 4 4 4 4 4 4 4 4 4 4 4 4 4 4 4 4 
4 4 4 4 4 4 4 4 4 4 4 4 4 4 4 4 4 4 4 4 4 4 4 4 4 4 4 4 4 4 4 4 4 4 4 4 4 4 4 4 4 4 4 4 4 4 4 4 4 4 4 4 4 4 4 4 4 4 4 4 
4 4 4 4 4 4 4 4 4 4 4 4 4 4 4 4 4 4 4 4 4 4 4 4 4 4 4 4 4 4 4 4 4 4 4 4 4 4 4 4 4 4 4 4 4 4 4 4 4 4 4 4 4 4 4 4 4 4 4 4 
4 4 4 4 4 4 4 4 4 4 4 4 4 4 4 4 4 4 4 4 4 4 4 4 4 1 1 4 4 4 4 4 4 4 4 4 4 4 4 4 4 1 1 4 4 12 12 4 4 4 4 4 4 4 4 4 4 4 4 4 
4 4 4 1 1 4 4 4 4 4 4 4 4 4 4 4 4 4 4 4 4 4 4 4 4 1 1 4 4 4 4 4 4 4 4 4 4 12 12 4 4 1 1 4 12 13 12 12 4 4 4 4 4 4 4 4 4 4 4 4 
4 4 4 1 1 4 4 4 4 4 4 4 4 4 4 4 4 4 4 4 12 12 12 4 4 4 4 4 1 1 4 4 1 1 4 4 4 4 13 4 4 4 4 4 12 13 12 12 4 4 4 4 12 12 4 4 4 4 4 4 
4 1 1 4 4 1 1 1 1 4 4 4 4 4 4 12 12 4 4 4 4 13 12 4 4 4 1 1 1 1 1 1 1 1 4 4 4 4 4 4 1 1 4 4 4 4 4 4 4 4 1 1 13 13 1 1 4 4 4 4 
4 1 1 4 4 1 1 1 1 1 1 4 4 1 1 13 13 1 1 4 4 4 4 4 1 1 1 1 4 4 1 1 4 1 1 4 4 1 1 4 1 1 1 1 4 4 1 1 1 1 1 1 13 13 5 1 4 4 4 4 
1 1 4 4 4 4 4 4 4 1 1 1 1 1 1 13 13 5 1 4 1 1 1 1 1 1 4 4 4 4 4 4 4 1 1 1 1 1 1 1 1 4 1 1 1 1 1 1 1 1 4 4 4 4 4 4 1 1 1 1 
1 1 4 4 4 4 4 4 4 4 4 1 1 4 4 4 4 4 1 1 1 1 1 1 4 4 4 1 1 4 4 4 4 4 4 1 1 4 4 1 1 4 4 4 1 1 4 4 4 4 4 1 1 4 4 4 1 1 1 1 
4 4 4 4 4 4 4 4 4 4 4 4 4 4 4 4 4 4 1 1 4 4 4 4 4 4 4 1 1 4 4 4 4 4 4 4 4 4 4 4 4 4 4 4 4 4 4 4 4 4 4 1 1 4 4 4 4 4 4 4 
