connections=[
		],
events={
	
		'exits':[{'name':'ROUTE 119 (0.34)','x':9,'y':12},{'name':'ROUTE 119 (0.34)','x':10,'y':12},{'name':'ROUTE 119 (32.1)','x':17,'y':1},		],
	
		'NPCs':[
			{'is_trainer':1,'b1':9,'b2':0,'sprite':'117','x':15,'y':3},
			{'is_trainer':1,'b1':8,'b2':0,'sprite':'118','x':10,'y':5},
			{'is_trainer':0,'b1':8,'b2':0,'sprite':'65','x':5,'y':4},
			{'is_trainer':0,'b1':1,'b2':0,'sprite':'65','x':2,'y':11},
			{'is_trainer':0,'b1':2,'b2':0,'sprite':'5','x':14,'y':11},
		],
	
		'signs':[
			{'x':1,'y':2},
			{'x':1,'y':3},
			{'x':0,'y':2},
			{'x':0,'y':3},
		],
	
		'triggers':[
		],

},
partial_map=[
	[1, 1, 1, 1, 1, 1, 1, 1, 1, 1, 1, 1, 1, 1, 1, 1, 1, 1, 1, 1, ],
	[1, 1, 1, 1, 1, 1, 1, 1, 1, 1, 1, 1, 1, 1, 1, 1, 1, 0, 1, 1, ],
	[1, 1, 12, 1, 12, 12, 12, 1, 1, 1, 1, 1, 12, 12, 12, 12, 12, 12, 12, 1, ],
	[1, 1, 12, 1, 12, 12, 12, 1, 12, 12, 12, 12, 12, 12, 12, 12, 12, 12, 12, 12, ],
	[12, 12, 12, 1, 12, 12, 12, 1, 12, 12, 12, 1, 1, 12, 12, 12, 1, 1, 12, 12, ],
	[12, 12, 12, 1, 12, 12, 12, 1, 12, 12, 12, 1, 1, 12, 12, 12, 1, 1, 12, 12, ],
	[12, 12, 12, 12, 12, 12, 12, 12, 12, 12, 12, 1, 1, 12, 12, 12, 1, 1, 12, 12, ],
	[12, 1, 12, 12, 12, 12, 12, 12, 12, 12, 12, 12, 12, 12, 12, 12, 12, 12, 12, 1, ],
	[1, 1, 1, 1, 12, 12, 12, 1, 1, 1, 1, 1, 1, 1, 1, 1, 1, 1, 1, 1, ],
	[1, 1, 1, 1, 12, 12, 12, 1, 1, 1, 1, 1, 1, 1, 1, 1, 1, 1, 1, 1, ],
	[12, 12, 12, 12, 12, 12, 12, 12, 12, 12, 12, 12, 12, 12, 12, 12, 12, 12, 12, 12, ],
	[12, 12, 12, 12, 12, 12, 12, 12, 12, 12, 12, 12, 12, 12, 12, 12, 12, 12, 12, 12, ],
	[12, 12, 12, 12, 12, 12, 12, 12, 1, 0, 0, 1, 12, 12, 12, 12, 12, 12, 12, 12, ],
]
