Connections;
Exits;ROUTE 109 (0.24);ROUTE 109 (0.24);
1 1 1 1 1 1 1 1 1 1 1 1 1 1 1 
1 1 1 1 1 1 1 1 1 1 1 1 1 1 1 
12 1 1 12 12 12 12 1 12 12 12 12 1 1 12 
12 12 12 12 12 12 12 12 12 12 12 12 12 12 12 
1 1 12 1 1 1 12 12 1 1 1 12 12 1 1 
12 12 12 12 12 12 12 12 12 12 12 12 12 12 12 
1 1 12 1 1 1 12 12 1 1 1 12 12 1 1 
12 12 12 12 12 12 12 12 12 12 12 12 12 12 12 
1 1 12 12 12 12 12 12 12 12 12 12 12 1 1 
12 12 12 12 12 12 0 0 12 12 12 12 12 12 12 
