connections=[
			{'up':'OLDALE TOWN (0.10)'},
			{'down':'LITTLEROOT TOWN (0.9)'},
		],
events={
	
		'exits':[		],
	
		'NPCs':[
			{'is_trainer':0,'b1':1,'b2':0,'sprite':'35','x':16,'y':8},
			{'is_trainer':0,'b1':71,'b2':0,'sprite':'64','x':9,'y':13},
			{'is_trainer':0,'b1':1,'b2':0,'sprite':'97','x':7,'y':14},
			{'is_trainer':0,'b1':70,'b2':0,'sprite':'98','x':10,'y':13},
			{'is_trainer':0,'b1':1,'b2':0,'sprite':'64','x':5,'y':11},
			{'is_trainer':0,'b1':5,'b2':0,'sprite':'9','x':2,'y':13},
		],
	
		'signs':[
			{'x':5,'y':9},
		],
	
		'triggers':[
			{'x':10,'y':19,'flag':16480,'scriptPointer':2014430},
			{'x':11,'y':19,'flag':16480,'scriptPointer':2014430},
			{'x':10,'y':18,'flag':16480,'scriptPointer':2014542},
			{'x':11,'y':18,'flag':16480,'scriptPointer':2014542},
			{'x':6,'y':16,'flag':16480,'scriptPointer':2014564},
			{'x':6,'y':15,'flag':16480,'scriptPointer':2014564},
			{'x':6,'y':17,'flag':16480,'scriptPointer':2014564},
			{'x':6,'y':18,'flag':16480,'scriptPointer':2014564},
			{'x':7,'y':13,'flag':16480,'scriptPointer':2014586},
		],

},
partial_map=[
	[1, 1, 1, 1, 1, 1, 1, 1, 12, 12, 12, 12, 1, 1, 1, 1, 1, 1, 1, 1, ],
	[1, 1, 1, 1, 1, 1, 1, 1, 12, 12, 12, 12, 1, 1, 1, 1, 1, 1, 1, 1, ],
	[1, 1, 12, 12, 12, 12, 12, 12, 12, 12, 12, 12, 12, 12, 12, 12, 1, 1, 1, 1, ],
	[1, 13, 12, 12, 12, 12, 12, 12, 12, 12, 12, 12, 12, 12, 12, 12, 1, 1, 1, 1, ],
	[12, 12, 12, 12, 12, 12, 12, 12, 12, 12, 12, 12, 12, 12, 12, 12, 12, 12, 1, 1, ],
	[12, 12, 12, 12, 12, 12, 12, 12, 12, 12, 12, 12, 12, 12, 12, 12, 12, 12, 1, 1, ],
	[1, 1, 12, 12, 12, 12, 1, 1, 1, 1, 1, 1, 1, 12, 12, 12, 12, 12, 12, 12, ],
	[1, 1, 1, 1, 1, 1, 1, 12, 12, 12, 12, 1, 1, 1, 1, 12, 12, 12, 12, 12, ],
	[1, 1, 12, 12, 12, 12, 12, 12, 12, 12, 12, 1, 1, 1, 1, 12, 12, 12, 12, 12, ],
	[1, 1, 1, 1, 12, 1, 12, 12, 12, 12, 12, 1, 1, 12, 12, 12, 12, 12, 12, 12, ],
	[1, 1, 1, 1, 12, 12, 12, 12, 12, 12, 12, 12, 12, 12, 12, 12, 12, 12, 12, 12, ],
	[1, 1, 1, 1, 12, 12, 12, 12, 12, 12, 12, 12, 12, 12, 12, 12, 12, 12, 12, 12, ],
	[1, 1, 1, 1, 12, 12, 12, 12, 12, 12, 12, 12, 12, 12, 12, 12, 12, 12, 12, 12, ],
	[1, 1, 12, 12, 12, 12, 12, 12, 1, 1, 1, 1, 12, 12, 12, 12, 12, 12, 12, 12, ],
	[12, 12, 12, 12, 12, 12, 12, 12, 12, 12, 12, 12, 1, 1, 12, 12, 12, 12, 1, 1, ],
	[12, 12, 12, 12, 12, 12, 12, 12, 12, 12, 12, 12, 1, 1, 12, 12, 12, 12, 1, 1, ],
	[1, 1, 12, 12, 12, 12, 12, 12, 12, 12, 12, 12, 1, 1, 1, 1, 1, 1, 1, 1, ],
	[1, 1, 12, 12, 12, 12, 12, 12, 12, 12, 12, 12, 1, 1, 1, 1, 1, 1, 1, 1, ],
	[1, 1, 1, 1, 1, 1, 1, 1, 1, 1, 12, 12, 1, 1, 1, 1, 1, 1, 1, 1, ],
	[1, 1, 1, 1, 1, 1, 1, 1, 1, 1, 12, 12, 1, 1, 1, 1, 1, 1, 1, 1, ],
]
