connections=[
			{up:SLATEPORT CITY (0.1)},
			{left:ROUTE 108 (0.23)},
		],
events={
	{
		exits:[ROUTE 109 (28.0),		]},
	{
		NPCs:[
			{is_trainer:0,b1:7,b2:0,sprite:88},
			{is_trainer:0,b1:7,b2:0,sprite:21},
			{is_trainer:1,b1:10,b2:0,sprite:42},
			{is_trainer:1,b1:15,b2:0,sprite:43},
			{is_trainer:1,b1:8,b2:0,sprite:49},
			{is_trainer:1,b1:9,b2:0,sprite:49},
			{is_trainer:1,b1:8,b2:0,sprite:54},
			{is_trainer:1,b1:80,b2:0,sprite:53},
			{is_trainer:0,b1:8,b2:0,sprite:12},
			{is_trainer:0,b1:1,b2:0,sprite:59},
			{is_trainer:1,b1:13,b2:0,sprite:53},
			{is_trainer:1,b1:17,b2:0,sprite:53},
			{is_trainer:1,b1:9,b2:0,sprite:50},
			{is_trainer:0,b1:10,b2:0,sprite:54},
			{is_trainer:0,b1:9,b2:0,sprite:53},
			{is_trainer:0,b1:8,b2:0,sprite:18},
			{is_trainer:1,b1:8,b2:0,sprite:26},
			{is_trainer:1,b1:8,b2:0,sprite:65},
			{is_trainer:0,b1:1,b2:0,sprite:29},
			{is_trainer:0,b1:1,b2:0,sprite:208},
			{is_trainer:1,b1:80,b2:0,sprite:53},
			{is_trainer:1,b1:79,b2:0,sprite:54},
			{is_trainer:0,b1:1,b2:0,sprite:59},
			{is_trainer:1,b1:80,b2:0,sprite:66},
		]},
	{
		signs:[
			{x:15,y:5},
			{x:29,y:10},
			{x:16,y:23},
			{x:33,y:5},
			{x:9,y:10},
			{x:28,y:20},
			{x:13,y:16},
			{x:8,y:42},
		]},
	{
		triggers:[
		]},

},
[
	[1, 1, 4, 4, 4, 4, 4, 4, 12, 12, 12, 12, 12, 12, 12, 12, 12, 12, 12, 12, 12, 12, 12, 12, 12, 12, 12, 12, 12, 12, 12, 12, 12, 12, 12, 12, 4, 4, 1, 1, ],
	[1, 1, 4, 4, 4, 4, 4, 4, 12, 12, 12, 12, 12, 12, 12, 12, 12, 12, 12, 12, 12, 12, 12, 12, 12, 12, 12, 12, 12, 12, 12, 12, 12, 12, 12, 12, 4, 4, 1, 1, ],
	[4, 1, 1, 4, 4, 4, 4, 4, 4, 12, 12, 12, 12, 12, 12, 12, 12, 12, 12, 12, 12, 12, 12, 12, 12, 12, 12, 12, 12, 12, 12, 12, 12, 12, 12, 4, 4, 4, 1, 1, ],
	[4, 1, 1, 4, 4, 4, 4, 4, 4, 12, 1, 1, 1, 1, 1, 12, 12, 12, 12, 12, 12, 12, 12, 12, 12, 12, 12, 12, 12, 12, 12, 12, 12, 12, 12, 4, 4, 4, 1, 1, ],
	[4, 4, 1, 1, 4, 4, 4, 4, 4, 12, 1, 1, 1, 1, 1, 12, 12, 12, 12, 12, 12, 12, 12, 12, 12, 12, 12, 12, 12, 12, 12, 12, 12, 12, 12, 4, 4, 4, 1, 1, ],
	[4, 4, 1, 1, 4, 4, 4, 4, 4, 12, 1, 1, 0, 1, 1, 1, 12, 12, 12, 12, 12, 12, 12, 12, 12, 12, 12, 12, 12, 12, 12, 12, 12, 12, 12, 4, 4, 4, 1, 1, ],
	[4, 4, 1, 1, 4, 4, 4, 4, 4, 12, 12, 12, 12, 12, 12, 12, 12, 12, 12, 12, 12, 12, 12, 12, 12, 12, 12, 12, 12, 12, 12, 12, 12, 12, 4, 4, 4, 4, 1, 1, ],
	[4, 4, 1, 1, 4, 4, 4, 4, 4, 12, 12, 12, 12, 12, 12, 12, 12, 12, 12, 12, 12, 12, 12, 12, 12, 12, 12, 12, 12, 12, 12, 12, 12, 12, 4, 4, 4, 1, 1, 4, ],
	[4, 1, 1, 4, 4, 4, 4, 4, 4, 12, 12, 12, 12, 12, 12, 12, 12, 12, 12, 12, 12, 12, 12, 12, 12, 12, 12, 12, 12, 12, 12, 12, 12, 12, 4, 4, 4, 1, 1, 4, ],
	[4, 1, 1, 4, 4, 4, 4, 4, 4, 12, 12, 12, 12, 12, 12, 12, 0, 16, 0, 12, 12, 12, 0, 16, 16, 0, 12, 12, 12, 12, 12, 12, 12, 12, 4, 4, 1, 1, 4, 4, ],
	[4, 4, 4, 1, 1, 4, 4, 4, 4, 12, 12, 12, 12, 0, 16, 16, 0, 16, 0, 12, 12, 12, 0, 16, 16, 0, 12, 12, 12, 13, 12, 12, 12, 4, 4, 4, 1, 1, 1, 1, ],
	[4, 4, 4, 1, 1, 4, 4, 4, 4, 12, 12, 12, 12, 0, 16, 16, 0, 0, 12, 12, 12, 12, 12, 0, 0, 12, 12, 12, 12, 12, 12, 12, 12, 4, 4, 4, 4, 4, 1, 1, ],
	[4, 4, 4, 4, 1, 1, 4, 4, 4, 4, 12, 0, 16, 0, 0, 0, 12, 12, 12, 12, 12, 12, 12, 12, 12, 12, 12, 12, 12, 12, 12, 12, 12, 4, 4, 4, 4, 1, 1, 4, ],
	[4, 4, 1, 1, 1, 1, 4, 4, 4, 4, 12, 0, 16, 0, 12, 12, 12, 12, 12, 12, 12, 12, 12, 12, 12, 12, 12, 12, 12, 12, 12, 12, 12, 4, 4, 4, 4, 1, 1, 4, ],
	[4, 4, 1, 5, 1, 4, 4, 4, 4, 4, 4, 12, 0, 12, 12, 12, 12, 12, 12, 0, 16, 16, 16, 16, 0, 12, 12, 0, 12, 12, 12, 12, 4, 4, 4, 4, 4, 4, 1, 1, ],
	[4, 4, 1, 1, 5, 4, 4, 4, 4, 4, 4, 12, 12, 12, 12, 12, 12, 0, 16, 0, 16, 16, 16, 16, 0, 12, 12, 12, 12, 12, 12, 12, 4, 4, 4, 4, 4, 4, 1, 1, ],
	[4, 4, 4, 4, 1, 1, 4, 4, 4, 4, 4, 12, 12, 12, 12, 12, 12, 0, 16, 0, 0, 0, 0, 0, 12, 12, 0, 12, 12, 12, 12, 12, 4, 4, 4, 4, 4, 1, 1, 4, ],
	[4, 4, 4, 4, 1, 1, 4, 4, 4, 4, 4, 4, 16, 0, 12, 12, 12, 12, 0, 12, 12, 12, 12, 12, 12, 12, 12, 12, 12, 12, 4, 4, 4, 4, 4, 4, 4, 1, 1, 4, ],
	[4, 4, 4, 1, 1, 4, 4, 4, 4, 4, 4, 4, 16, 0, 12, 0, 16, 16, 0, 12, 12, 12, 0, 16, 0, 12, 12, 12, 12, 12, 4, 4, 4, 4, 4, 4, 1, 1, 4, 4, ],
	[4, 4, 4, 1, 1, 4, 4, 4, 4, 4, 4, 4, 4, 12, 12, 0, 16, 16, 0, 12, 12, 12, 0, 16, 0, 12, 12, 12, 12, 4, 4, 4, 4, 4, 4, 4, 1, 1, 4, 4, ],
	[4, 4, 4, 1, 1, 4, 4, 4, 4, 4, 4, 4, 4, 12, 12, 12, 0, 0, 12, 12, 12, 12, 12, 0, 12, 12, 12, 12, 12, 4, 4, 4, 4, 4, 4, 4, 4, 1, 1, 4, ],
	[4, 4, 4, 1, 1, 1, 1, 4, 4, 4, 4, 4, 4, 4, 4, 4, 12, 12, 12, 12, 12, 12, 12, 12, 12, 12, 12, 4, 4, 4, 4, 4, 4, 4, 4, 4, 4, 1, 1, 4, ],
	[4, 4, 4, 4, 4, 1, 1, 4, 4, 4, 4, 4, 4, 4, 4, 4, 12, 12, 12, 12, 12, 12, 12, 12, 12, 12, 12, 4, 4, 4, 4, 4, 4, 4, 4, 4, 4, 1, 5, 1, ],
	[4, 4, 4, 4, 4, 4, 1, 1, 4, 4, 4, 4, 4, 4, 4, 4, 12, 12, 12, 12, 12, 12, 12, 12, 12, 4, 4, 4, 4, 4, 4, 4, 4, 4, 4, 4, 1, 5, 0, 1, ],
	[4, 4, 4, 4, 4, 4, 1, 1, 4, 4, 4, 4, 4, 4, 4, 4, 4, 4, 4, 12, 12, 12, 12, 4, 4, 4, 4, 4, 4, 4, 4, 4, 4, 4, 4, 4, 1, 0, 1, 5, ],
	[4, 4, 4, 4, 4, 1, 1, 4, 4, 4, 4, 4, 4, 4, 4, 4, 4, 4, 4, 4, 4, 4, 4, 4, 4, 4, 4, 4, 4, 4, 4, 4, 4, 4, 4, 4, 1, 0, 1, 4, ],
	[4, 4, 4, 4, 4, 1, 1, 4, 4, 4, 4, 4, 4, 4, 4, 4, 4, 4, 4, 4, 4, 4, 4, 4, 4, 4, 4, 4, 4, 4, 4, 4, 4, 4, 1, 1, 1, 1, 5, 4, ],
	[4, 4, 4, 4, 1, 5, 1, 4, 4, 4, 4, 4, 4, 4, 4, 4, 4, 4, 4, 4, 4, 4, 4, 4, 4, 4, 4, 4, 4, 4, 4, 4, 4, 4, 1, 1, 4, 4, 4, 4, ],
	[4, 4, 4, 1, 5, 0, 1, 1, 1, 4, 4, 4, 4, 4, 4, 4, 4, 4, 4, 4, 4, 4, 4, 4, 4, 4, 4, 12, 12, 4, 4, 4, 4, 4, 4, 4, 1, 1, 4, 4, ],
	[4, 4, 4, 1, 0, 0, 1, 1, 1, 4, 4, 4, 4, 4, 4, 4, 4, 4, 4, 4, 4, 4, 4, 4, 4, 4, 12, 12, 12, 12, 12, 4, 4, 4, 4, 4, 1, 1, 4, 4, ],
	[4, 4, 4, 1, 0, 1, 5, 4, 4, 4, 4, 4, 4, 4, 4, 4, 4, 4, 4, 4, 4, 4, 4, 4, 4, 12, 12, 12, 12, 12, 12, 12, 12, 4, 4, 1, 1, 4, 4, 4, ],
	[4, 4, 4, 1, 1, 5, 4, 4, 4, 4, 4, 4, 4, 4, 4, 4, 4, 4, 4, 4, 4, 4, 4, 4, 4, 12, 12, 12, 12, 12, 12, 12, 12, 4, 4, 1, 1, 4, 4, 4, ],
	[4, 4, 1, 1, 4, 4, 1, 1, 4, 4, 4, 4, 4, 4, 4, 4, 4, 4, 4, 4, 4, 4, 4, 4, 4, 12, 12, 12, 12, 12, 12, 12, 12, 4, 4, 4, 1, 1, 4, 4, ],
	[4, 4, 1, 1, 4, 4, 1, 1, 1, 1, 4, 4, 4, 4, 4, 4, 4, 4, 4, 4, 4, 4, 4, 4, 4, 12, 12, 12, 12, 12, 12, 12, 4, 4, 4, 4, 1, 1, 4, 4, ],
	[4, 4, 4, 4, 4, 4, 4, 4, 1, 1, 4, 4, 4, 4, 4, 4, 4, 4, 4, 4, 4, 4, 4, 4, 4, 4, 4, 12, 12, 12, 4, 4, 4, 4, 4, 1, 1, 4, 4, 4, ],
	[4, 4, 4, 4, 4, 4, 1, 5, 1, 4, 4, 4, 4, 4, 4, 4, 4, 4, 4, 4, 4, 4, 4, 4, 4, 4, 4, 4, 4, 4, 4, 4, 4, 4, 4, 1, 1, 4, 4, 4, ],
	[4, 4, 4, 4, 1, 1, 1, 0, 1, 4, 4, 4, 4, 4, 4, 4, 4, 4, 4, 4, 4, 4, 4, 4, 4, 4, 4, 4, 4, 4, 4, 4, 4, 4, 1, 1, 4, 4, 4, 4, ],
	[4, 4, 4, 4, 1, 1, 1, 1, 5, 4, 4, 4, 4, 4, 4, 4, 4, 4, 4, 4, 4, 4, 4, 4, 4, 4, 4, 4, 4, 4, 4, 4, 4, 4, 1, 1, 4, 4, 4, 4, ],
	[4, 4, 4, 1, 1, 4, 4, 4, 4, 4, 4, 4, 4, 4, 4, 4, 4, 4, 4, 4, 4, 4, 4, 4, 4, 4, 4, 4, 4, 4, 4, 4, 4, 1, 1, 4, 4, 4, 4, 4, ],
	[4, 4, 4, 1, 1, 4, 4, 4, 4, 4, 4, 4, 4, 4, 4, 4, 4, 4, 4, 4, 4, 4, 4, 4, 4, 4, 4, 4, 4, 4, 4, 4, 4, 1, 1, 4, 4, 4, 4, 4, ],
	[4, 4, 1, 1, 4, 4, 4, 4, 12, 12, 4, 4, 4, 4, 4, 4, 4, 4, 4, 4, 4, 4, 4, 4, 4, 4, 4, 4, 4, 4, 4, 1, 1, 4, 4, 5, 5, 4, 4, 4, ],
	[1, 1, 1, 1, 4, 4, 4, 12, 12, 12, 4, 4, 4, 4, 4, 4, 4, 4, 4, 4, 4, 4, 4, 4, 4, 4, 4, 4, 4, 4, 4, 1, 1, 4, 4, 5, 5, 4, 4, 4, ],
	[1, 1, 4, 4, 4, 4, 4, 12, 12, 12, 4, 4, 4, 4, 4, 4, 4, 4, 4, 4, 4, 4, 4, 4, 4, 4, 4, 12, 12, 4, 4, 4, 1, 1, 4, 4, 4, 4, 4, 4, ],
	[4, 4, 5, 5, 4, 4, 4, 12, 12, 4, 4, 4, 4, 4, 4, 4, 4, 4, 4, 4, 4, 4, 4, 4, 4, 4, 12, 12, 12, 4, 4, 4, 1, 1, 4, 4, 4, 4, 4, 4, ],
	[4, 4, 5, 5, 4, 4, 4, 4, 4, 4, 4, 4, 4, 4, 4, 4, 4, 4, 4, 4, 4, 4, 4, 4, 4, 4, 12, 12, 12, 12, 4, 4, 4, 1, 1, 4, 4, 4, 4, 4, ],
	[4, 4, 4, 4, 4, 4, 4, 4, 4, 4, 4, 4, 4, 4, 4, 4, 4, 4, 4, 4, 4, 4, 4, 4, 4, 12, 12, 12, 12, 12, 4, 4, 4, 1, 1, 4, 4, 4, 4, 4, ],
	[4, 4, 4, 4, 4, 4, 4, 4, 4, 4, 4, 4, 4, 4, 4, 4, 4, 4, 4, 4, 4, 4, 4, 4, 4, 12, 12, 12, 12, 12, 4, 4, 4, 4, 1, 1, 4, 4, 4, 4, ],
	[4, 4, 4, 4, 4, 4, 4, 4, 4, 4, 4, 4, 4, 4, 4, 4, 4, 4, 4, 4, 4, 4, 4, 4, 4, 12, 12, 12, 12, 4, 4, 4, 4, 4, 1, 1, 4, 4, 4, 4, ],
	[4, 4, 4, 4, 4, 4, 4, 4, 4, 4, 4, 4, 4, 4, 4, 4, 4, 4, 4, 4, 4, 4, 4, 4, 4, 4, 4, 4, 4, 4, 4, 4, 4, 1, 1, 4, 4, 4, 4, 4, ],
	[4, 4, 4, 4, 4, 4, 4, 4, 4, 4, 4, 4, 4, 4, 4, 4, 4, 4, 4, 4, 4, 4, 4, 4, 4, 4, 4, 4, 4, 4, 4, 4, 4, 1, 1, 4, 4, 4, 4, 4, ],
	[4, 4, 4, 4, 4, 4, 4, 4, 4, 4, 4, 4, 4, 4, 4, 4, 4, 4, 4, 4, 4, 4, 4, 4, 4, 4, 4, 4, 4, 4, 4, 4, 4, 4, 1, 1, 4, 4, 4, 4, ],
	[4, 4, 4, 4, 4, 4, 4, 4, 4, 4, 4, 4, 4, 4, 4, 4, 12, 12, 12, 12, 12, 4, 4, 4, 4, 4, 4, 4, 4, 4, 4, 4, 4, 4, 1, 1, 4, 4, 4, 4, ],
	[4, 4, 4, 4, 4, 4, 4, 4, 4, 4, 4, 4, 4, 4, 4, 4, 12, 12, 12, 12, 12, 4, 4, 4, 4, 4, 4, 4, 4, 4, 4, 4, 4, 1, 1, 4, 4, 4, 4, 4, ],
	[4, 4, 4, 4, 4, 4, 4, 4, 4, 4, 4, 4, 4, 4, 4, 4, 12, 0, 16, 0, 12, 4, 4, 4, 4, 4, 4, 4, 4, 4, 4, 4, 4, 1, 1, 4, 4, 4, 4, 4, ],
	[4, 4, 1, 1, 1, 1, 4, 4, 1, 1, 4, 4, 4, 4, 4, 4, 12, 0, 16, 0, 12, 4, 4, 4, 4, 4, 4, 4, 4, 4, 4, 4, 4, 1, 5, 1, 4, 4, 4, 4, ],
	[1, 1, 1, 1, 1, 1, 4, 4, 1, 1, 4, 4, 4, 4, 4, 4, 12, 12, 0, 12, 12, 12, 4, 4, 1, 1, 4, 4, 4, 4, 4, 4, 1, 5, 0, 1, 4, 4, 4, 4, ],
	[1, 1, 4, 4, 4, 1, 1, 1, 5, 1, 4, 4, 4, 4, 4, 12, 12, 12, 12, 0, 16, 0, 12, 4, 1, 1, 4, 4, 4, 4, 1, 1, 1, 0, 1, 5, 4, 4, 4, 4, ],
	[4, 4, 4, 4, 4, 1, 1, 1, 0, 1, 4, 4, 4, 4, 4, 12, 12, 12, 12, 0, 16, 0, 12, 4, 1, 1, 1, 1, 4, 4, 1, 1, 1, 1, 5, 4, 4, 4, 4, 4, ],
	[4, 4, 4, 4, 4, 4, 4, 1, 1, 5, 4, 4, 4, 4, 4, 4, 4, 4, 12, 12, 0, 12, 4, 4, 1, 1, 1, 1, 1, 1, 4, 4, 4, 4, 4, 4, 4, 4, 4, 4, ],
	[4, 4, 4, 4, 4, 4, 4, 4, 4, 1, 1, 4, 4, 4, 1, 1, 4, 4, 4, 4, 12, 4, 4, 1, 1, 4, 4, 4, 1, 1, 4, 4, 4, 4, 4, 4, 4, 4, 4, 4, ],
	[4, 4, 4, 4, 4, 4, 4, 4, 4, 1, 1, 5, 5, 4, 1, 1, 4, 4, 4, 4, 4, 4, 4, 1, 1, 4, 4, 4, 4, 4, 4, 4, 4, 4, 4, 4, 4, 4, 4, 4, ],
	[4, 4, 4, 4, 4, 4, 4, 4, 4, 4, 4, 1, 5, 1, 1, 1, 1, 1, 1, 1, 1, 1, 1, 4, 4, 4, 4, 4, 4, 4, 4, 4, 4, 4, 4, 4, 4, 4, 4, 4, ],
	[4, 4, 4, 4, 4, 4, 4, 4, 4, 4, 4, 4, 4, 1, 1, 1, 1, 1, 1, 1, 1, 1, 1, 4, 4, 4, 4, 4, 4, 4, 4, 4, 4, 4, 4, 4, 4, 4, 4, 4, ],
]
