Connections;
Exits;ROUTE 114 (0.29);ROUTE 114 (0.29);ROUTE 114 (20.1);
1 1 1 1 1 1 1 1 1 1 
1 1 1 1 0 13 1 1 1 1 
12 12 12 12 12 12 12 1 1 12 
12 12 12 12 12 13 13 12 12 12 
12 1 1 12 12 12 12 12 12 12 
12 1 1 12 12 12 12 12 12 12 
12 12 12 12 12 12 12 12 12 12 
12 12 12 12 0 0 12 12 12 12 
