connections=[
		],
events={
	
		'exits':[{'name':'ROUTE 110 (29.3)','x':10,'y':1},{'name':'ROUTE 110 (29.2)','x':2,'y':1},		],
	
		'NPCs':[
			{'is_trainer':0,'b1':10,'b2':0,'sprite':'19','x':4,'y':5},
		],
	
		'signs':[
			{'x':4,'y':5},
		],
	
		'triggers':[
			{'x':2,'y':2,'flag':16386,'scriptPointer':2535489},
		],

},
partial_map=[
	[1, 1, 1, 1, 1, 1, 1, 1, 1, 1, 1, 1, ],
	[1, 1, 12, 1, 1, 1, 1, 1, 1, 13, 12, 13, ],
	[12, 12, 12, 12, 12, 12, 12, 12, 12, 12, 12, 12, ],
	[12, 12, 12, 12, 12, 12, 12, 12, 12, 12, 12, 12, ],
	[12, 12, 12, 12, 12, 1, 1, 12, 12, 12, 12, 12, ],
	[12, 12, 12, 12, 12, 1, 1, 12, 12, 12, 12, 12, ],
	[12, 12, 12, 12, 12, 12, 12, 12, 12, 12, 12, 12, ],
	[12, 12, 12, 12, 12, 12, 12, 12, 12, 12, 12, 12, ],
]
