connections=[
		],
events={
	
		'exits':[{'name':'RUSTBORO CITY (11.14)','x':1,'y':1},		],
	
		'NPCs':[
			{'is_trainer':0,'b1':5,'b2':0,'sprite':'116','x':7,'y':3},
			{'is_trainer':0,'b1':8,'b2':0,'sprite':'16','x':12,'y':2},
		],
	
		'signs':[
		],
	
		'triggers':[
		],

},
partial_map=[
	[1, 1, 1, 1, 1, 1, 1, 1, 1, 1, 1, 1, 1, 1, ],
	[1, 0, 1, 1, 1, 1, 1, 1, 1, 1, 1, 1, 1, 1, ],
	[12, 12, 12, 12, 1, 12, 12, 12, 12, 12, 12, 12, 12, 12, ],
	[12, 12, 12, 12, 1, 12, 12, 12, 12, 12, 12, 12, 12, 12, ],
	[12, 12, 12, 12, 1, 12, 12, 12, 12, 12, 12, 12, 12, 12, ],
	[12, 12, 12, 12, 1, 12, 12, 12, 12, 12, 12, 12, 12, 12, ],
	[12, 12, 12, 12, 1, 12, 12, 12, 1, 1, 1, 1, 1, 1, ],
	[12, 12, 12, 12, 1, 12, 12, 12, 1, 1, 1, 1, 1, 1, ],
	[12, 12, 12, 12, 12, 12, 12, 12, 12, 12, 12, 12, 12, 12, ],
]
