connections=[
		],
events={
	
		'exits':[{'name':'RUSTBORO CITY (0.3)','x':5,'y':8},{'name':'RUSTBORO CITY (0.3)','x':6,'y':8},		],
	
		'NPCs':[
			{'is_trainer':0,'b1':10,'b2':0,'sprite':'25','x':7,'y':5},
			{'is_trainer':0,'b1':5,'b2':0,'sprite':'47','x':9,'y':2},
		],
	
		'signs':[
		],
	
		'triggers':[
		],

},
partial_map=[
	[1, 1, 1, 1, 1, 1, 1, 1, 1, 1, 1, ],
	[1, 1, 1, 1, 1, 1, 1, 1, 1, 1, 1, ],
	[12, 12, 12, 12, 12, 12, 12, 12, 12, 12, 12, ],
	[12, 12, 12, 12, 12, 12, 12, 12, 12, 12, 12, ],
	[12, 12, 12, 12, 12, 12, 12, 12, 13, 13, 12, ],
	[12, 12, 12, 12, 12, 12, 12, 12, 13, 13, 12, ],
	[12, 12, 12, 12, 12, 12, 12, 12, 12, 12, 12, ],
	[12, 12, 12, 12, 12, 12, 12, 12, 12, 12, 12, ],
	[13, 13, 12, 12, 12, 0, 0, 12, 12, 12, 12, ],
]
