Connections;
Exits;RUSTBORO CITY (11.1);
1 1 1 1 1 1 1 1 1 1 1 1 1 1 1 1 1 1 1 
1 1 0 1 1 1 1 1 1 1 1 1 1 1 1 1 1 1 1 
12 12 12 12 12 12 12 12 12 12 12 12 12 12 12 12 12 12 12 
12 12 12 12 12 0 12 12 12 12 12 12 12 12 12 12 12 0 12 
12 12 12 12 12 16 0 1 1 1 1 1 12 12 12 1 1 16 12 
12 1 12 12 12 16 0 1 1 1 1 1 12 12 12 1 1 16 12 
12 12 12 12 0 16 0 1 1 1 1 1 12 12 12 1 1 16 0 
12 1 12 12 12 0 12 12 12 12 12 12 12 12 12 12 12 0 12 
12 12 12 12 12 12 12 12 12 12 12 12 12 12 12 12 12 12 12 
