Connections;
Exits;RUSTBORO CITY (0.3);RUSTBORO CITY (0.3);RUSTBORO CITY (11.1);
1 1 1 1 1 1 1 1 1 1 1 1 1 1 12 1 1 1 1 
1 1 1 1 1 1 1 1 1 1 1 1 1 1 0 1 1 1 1 
1 1 1 1 12 12 12 12 1 1 1 1 1 12 12 12 1 1 1 
1 1 1 0 12 12 12 12 0 1 1 1 1 12 12 12 1 1 1 
1 1 1 1 1 1 1 1 12 1 1 1 1 12 12 12 1 1 1 
12 12 12 12 12 12 12 12 12 12 12 12 12 12 12 12 12 12 12 
12 12 12 12 12 12 12 12 12 12 12 12 12 12 12 12 12 12 12 
12 12 12 12 12 12 12 12 12 12 12 12 12 12 12 12 12 12 12 
12 12 12 12 12 12 12 12 12 12 12 12 12 12 12 12 12 12 12 
