Connections;
Exits;RUSTBORO CITY (11.13);RUSTBORO CITY (11.15);
1 1 1 1 1 1 1 1 1 1 1 1 1 1 
1 0 1 0 1 1 1 1 1 1 1 1 1 1 
12 12 12 12 12 1 12 12 12 12 12 12 13 13 
12 12 12 12 12 1 12 12 12 12 12 12 13 13 
12 12 12 12 12 1 12 12 12 12 12 12 13 13 
12 12 12 12 12 1 12 12 12 12 12 12 12 12 
12 12 12 12 12 1 12 12 1 1 1 1 1 1 
12 12 12 12 12 1 12 12 1 1 1 1 1 1 
12 12 12 12 12 12 12 12 12 12 12 12 12 12 
