connections=[
		],
events={
	{
		exits:[RUSTBORO CITY (0.3),RUSTBORO CITY (0.3),		]},
	{
		NPCs:[
			{is_trainer:0,b1:10,b2:0,sprite:189},
			{is_trainer:0,b1:9,b2:0,sprite:189},
			{is_trainer:0,b1:7,b2:0,sprite:15},
			{is_trainer:0,b1:7,b2:0,sprite:47},
			{is_trainer:0,b1:8,b2:0,sprite:38},
			{is_trainer:0,b1:8,b2:0,sprite:48},
			{is_trainer:0,b1:7,b2:0,sprite:219},
		]},
	{
		signs:[
			{x:5,y:2},
			{x:4,y:2},
			{x:6,y:2},
			{x:7,y:2},
			{x:3,y:5},
		]},
	{
		triggers:[
		]},

},
[
	[1, 1, 1, 1, 1, 1, 1, 1, 1, 1, 1, 1, ],
	[1, 1, 1, 1, 1, 1, 1, 1, 1, 1, 1, 1, ],
	[12, 12, 12, 12, 1, 1, 1, 1, 12, 12, 12, 12, ],
	[12, 12, 12, 12, 12, 12, 12, 12, 12, 12, 12, 12, ],
	[12, 12, 12, 12, 12, 1, 1, 12, 12, 12, 12, 12, ],
	[12, 1, 12, 1, 12, 12, 12, 12, 1, 12, 1, 12, ],
	[12, 12, 12, 12, 12, 12, 12, 12, 12, 12, 12, 12, ],
	[12, 1, 12, 1, 12, 12, 12, 12, 1, 12, 1, 12, ],
	[12, 12, 12, 12, 12, 12, 12, 12, 12, 12, 12, 12, ],
	[12, 1, 12, 1, 12, 12, 12, 12, 1, 12, 1, 12, ],
	[12, 12, 12, 12, 12, 0, 0, 12, 12, 12, 12, 12, ],
]
