connections=[
		],
events={
	{
		exits:[RUSTBORO CITY (0.3),RUSTBORO CITY (0.3),		]},
	{
		NPCs:[
			{is_trainer:0,b1:10,b2:0,sprite:25},
			{is_trainer:0,b1:5,b2:0,sprite:47},
		]},
	{
		signs:[
		]},
	{
		triggers:[
		]},

},
[
	[1, 1, 1, 1, 1, 1, 1, 1, 1, 1, 1, ],
	[1, 1, 1, 1, 1, 1, 1, 1, 1, 1, 1, ],
	[12, 12, 12, 12, 12, 12, 12, 12, 12, 12, 12, ],
	[12, 12, 12, 12, 12, 12, 12, 12, 12, 12, 12, ],
	[12, 12, 12, 12, 12, 12, 12, 12, 13, 13, 12, ],
	[12, 12, 12, 12, 12, 12, 12, 12, 13, 13, 12, ],
	[12, 12, 12, 12, 12, 12, 12, 12, 12, 12, 12, ],
	[12, 12, 12, 12, 12, 12, 12, 12, 12, 12, 12, ],
	[13, 13, 12, 12, 12, 0, 0, 12, 12, 12, 12, ],
]
