Connections;
Exits;RUSTBORO CITY (0.3);RUSTBORO CITY (0.3);
1 1 1 1 1 1 1 1 1 1 1 1 1 
1 1 1 1 1 1 1 1 1 1 1 1 1 
13 12 12 12 12 12 12 12 12 12 12 12 13 
12 12 12 12 12 12 12 12 12 12 12 12 12 
12 12 12 13 13 13 12 12 12 12 12 12 12 
12 12 12 13 13 13 12 12 12 12 12 12 12 
12 12 12 12 12 12 12 12 12 12 12 12 12 
13 12 12 12 12 0 0 12 12 12 12 12 13 
