Connections;
Exits;RUSTBORO CITY (11.8);
1 1 1 1 1 1 1 1 1 1 1 1 1 1 
1 1 0 1 1 1 1 1 1 1 1 1 1 1 
12 12 12 12 12 12 12 12 12 12 12 12 12 12 
12 12 12 12 12 12 12 12 12 12 12 12 12 12 
12 12 13 13 13 12 12 0 0 0 0 0 12 12 
12 12 13 13 13 12 12 0 12 13 12 0 12 12 
12 12 12 12 12 12 12 0 12 1 12 0 12 12 
12 13 13 12 12 12 12 0 0 0 0 0 12 12 
