connections=[
		],
events={
	
		'exits':[{'name':'RUSTBORO CITY (0.3)','x':5,'y':19},{'name':'RUSTBORO CITY (0.3)','x':6,'y':19},		],
	
		'NPCs':[
			{'is_trainer':0,'b1':8,'b2':0,'sprite':'125','x':5,'y':2},
			{'is_trainer':1,'b1':8,'b2':0,'sprite':'35','x':5,'y':13},
			{'is_trainer':1,'b1':9,'b2':0,'sprite':'35','x':3,'y':9},
			{'is_trainer':0,'b1':8,'b2':0,'sprite':'23','x':3,'y':18},
			{'is_trainer':1,'b1':8,'b2':0,'sprite':'55','x':1,'y':6},
		],
	
		'signs':[
			{'x':2,'y':18},
			{'x':8,'y':18},
		],
	
		'triggers':[
		],

},
partial_map=[
	[1, 1, 1, 1, 1, 1, 1, 1, 1, 1, 1, ],
	[1, 1, 1, 1, 1, 1, 1, 1, 1, 1, 1, ],
	[1, 12, 12, 13, 12, 12, 12, 13, 12, 12, 1, ],
	[12, 12, 12, 13, 12, 12, 12, 13, 12, 12, 12, ],
	[12, 12, 12, 12, 12, 12, 12, 12, 12, 12, 12, ],
	[12, 12, 12, 12, 12, 12, 12, 12, 12, 12, 12, ],
	[1, 12, 12, 1, 1, 1, 1, 1, 1, 1, 1, ],
	[1, 12, 12, 1, 1, 1, 1, 1, 1, 1, 1, ],
	[1, 12, 12, 12, 12, 12, 12, 12, 12, 1, 1, ],
	[1, 12, 12, 12, 1, 12, 1, 1, 12, 1, 1, ],
	[1, 12, 12, 12, 1, 12, 1, 1, 12, 1, 1, ],
	[1, 12, 1, 1, 1, 12, 12, 12, 12, 1, 1, ],
	[1, 12, 12, 12, 12, 12, 1, 1, 1, 1, 1, ],
	[1, 12, 1, 1, 12, 12, 12, 1, 1, 1, 1, ],
	[1, 12, 1, 1, 12, 12, 12, 12, 12, 1, 1, ],
	[1, 12, 1, 1, 1, 12, 1, 1, 12, 1, 1, ],
	[12, 12, 12, 12, 12, 12, 12, 12, 12, 12, 12, ],
	[12, 12, 12, 12, 12, 12, 12, 12, 12, 12, 12, ],
	[12, 12, 1, 12, 12, 12, 12, 12, 1, 12, 12, ],
	[12, 12, 12, 12, 12, 12, 12, 12, 12, 12, 12, ],
]
