connections=[
		],
events={
	{
		exits:[RUSTBORO CITY (0.3),RUSTBORO CITY (0.3),RUSTBORO CITY (11.14),		]},
	{
		NPCs:[
			{is_trainer:0,b1:9,b2:0,sprite:203},
			{is_trainer:0,b1:10,b2:0,sprite:30},
		]},
	{
		signs:[
		]},
	{
		triggers:[
		]},

},
[
	[1, 1, 1, 1, 1, 1, 1, 1, 1, 1, 1, 1, 1, 1, ],
	[1, 1, 1, 0, 1, 1, 1, 1, 1, 1, 1, 1, 1, 1, ],
	[12, 12, 12, 12, 12, 1, 12, 12, 12, 12, 12, 12, 12, 12, ],
	[12, 12, 12, 12, 12, 1, 12, 12, 12, 1, 1, 12, 12, 12, ],
	[12, 12, 12, 12, 12, 1, 12, 12, 12, 1, 1, 12, 12, 12, ],
	[12, 12, 12, 12, 12, 1, 12, 12, 12, 12, 12, 12, 12, 12, ],
	[12, 12, 12, 12, 12, 1, 12, 12, 1, 1, 1, 1, 1, 1, ],
	[12, 12, 12, 12, 12, 1, 12, 12, 1, 1, 1, 1, 1, 1, ],
	[12, 12, 0, 0, 12, 12, 12, 12, 12, 12, 12, 12, 12, 12, ],
]
