connections=[
		],
events={
	
		'exits':[{'name':'RUSTBORO CITY (11.13)','x':3,'y':1},{'name':'RUSTBORO CITY (11.15)','x':1,'y':1},		],
	
		'NPCs':[
			{'is_trainer':0,'b1':10,'b2':0,'sprite':'29','x':11,'y':4},
			{'is_trainer':0,'b1':5,'b2':0,'sprite':'5','x':7,'y':3},
		],
	
		'signs':[
		],
	
		'triggers':[
		],

},
partial_map=[
	[1, 1, 1, 1, 1, 1, 1, 1, 1, 1, 1, 1, 1, 1, ],
	[1, 0, 1, 0, 1, 1, 1, 1, 1, 1, 1, 1, 1, 1, ],
	[12, 12, 12, 12, 12, 1, 12, 12, 12, 12, 12, 12, 13, 13, ],
	[12, 12, 12, 12, 12, 1, 12, 12, 12, 12, 12, 12, 13, 13, ],
	[12, 12, 12, 12, 12, 1, 12, 12, 12, 12, 12, 12, 13, 13, ],
	[12, 12, 12, 12, 12, 1, 12, 12, 12, 12, 12, 12, 12, 12, ],
	[12, 12, 12, 12, 12, 1, 12, 12, 1, 1, 1, 1, 1, 1, ],
	[12, 12, 12, 12, 12, 1, 12, 12, 1, 1, 1, 1, 1, 1, ],
	[12, 12, 12, 12, 12, 12, 12, 12, 12, 12, 12, 12, 12, 12, ],
]
