Connections;
Exits;RUSTBORO CITY (0.3);RUSTBORO CITY (0.3);RUSTBORO CITY (11.9);
1 1 1 1 1 1 1 1 1 1 1 1 1 1 
1 1 0 1 1 1 1 1 1 1 1 1 1 1 
12 12 12 12 12 12 12 12 12 12 12 12 12 12 
12 12 12 12 12 12 12 12 12 12 12 12 12 12 
12 13 13 12 12 12 12 12 12 12 13 13 12 12 
12 13 13 12 12 12 12 12 12 12 13 13 12 12 
12 12 12 12 12 12 12 12 12 12 12 12 12 12 
13 13 12 12 12 12 0 0 12 12 12 12 12 12 
