connections=[
		],
events={
	{
		exits:[RUSTBORO CITY (0.3),RUSTBORO CITY (0.3),		]},
	{
		NPCs:[
			{is_trainer:0,b1:9,b2:0,sprite:31},
			{is_trainer:0,b1:8,b2:0,sprite:55},
		]},
	{
		signs:[
		]},
	{
		triggers:[
		]},

},
[
	[1, 1, 1, 1, 1, 1, 1, 1, 1, 1, 1, 1, 1, ],
	[1, 1, 1, 1, 1, 1, 1, 1, 1, 1, 1, 1, 1, ],
	[13, 12, 12, 12, 12, 12, 12, 12, 12, 12, 12, 12, 13, ],
	[12, 12, 12, 12, 12, 12, 12, 12, 12, 12, 12, 12, 12, ],
	[12, 12, 12, 13, 13, 13, 12, 12, 12, 12, 12, 12, 12, ],
	[12, 12, 12, 13, 13, 13, 12, 12, 12, 12, 12, 12, 12, ],
	[12, 12, 12, 12, 12, 12, 12, 12, 12, 12, 12, 12, 12, ],
	[13, 12, 12, 12, 12, 0, 0, 12, 12, 12, 12, 12, 13, ],
]
