Connections;
Exits;SAFARI ZONE (26.2);SAFARI ZONE (26.2);
1 1 1 1 1 1 1 1 1 1 
1 1 1 1 1 1 1 1 1 1 
1 1 1 1 1 1 1 1 1 1 
1 1 1 1 1 1 1 1 1 1 
12 12 12 12 12 12 12 12 12 12 
12 12 12 13 13 12 12 12 12 12 
12 12 12 13 13 12 12 12 12 12 
12 12 12 12 12 12 12 12 12 12 
12 12 12 0 0 12 12 12 12 12 
