Connections;right:SAFARI ZONE (26.1);down:SAFARI ZONE (26.2);
Exits;
1 1 1 1 1 1 1 1 12 1 1 1 1 1 12 12 12 12 12 12 1 1 1 1 1 1 1 1 1 1 1 1 1 1 1 1 1 1 12 12 
1 1 1 1 1 1 1 1 12 12 12 12 12 1 1 1 1 1 1 1 1 1 1 1 1 1 1 1 1 1 1 1 1 1 1 1 12 1 1 1 
1 1 1 1 1 1 1 1 1 1 1 1 1 1 1 1 1 1 1 1 1 1 1 1 1 1 1 1 1 1 1 12 12 12 12 1 1 1 1 1 
1 1 1 1 1 1 1 1 1 1 1 1 1 1 1 1 1 1 1 1 1 1 1 1 1 1 1 1 1 12 1 1 1 1 1 1 1 1 12 12 
1 1 1 1 1 1 1 1 1 1 1 1 1 1 1 1 20 1 1 1 1 1 1 1 1 12 12 12 1 1 1 1 1 1 1 1 12 1 1 1 
1 1 1 1 1 1 1 1 1 1 1 1 1 1 1 1 20 1 1 1 1 1 1 1 1 1 1 1 1 1 1 1 1 1 12 1 1 1 1 1 
1 1 20 20 20 20 20 20 1 1 1 1 1 1 20 1 1 1 1 1 1 1 1 1 4 4 4 4 4 4 4 4 13 1 1 1 12 12 12 12 
1 1 20 20 1 20 20 20 1 1 1 1 1 1 20 1 1 1 1 1 1 1 1 1 4 4 4 4 4 4 4 4 12 12 12 1 1 1 1 1 
1 1 20 20 20 20 20 20 20 20 20 1 1 1 1 1 1 1 1 1 1 1 1 1 4 4 4 4 4 4 4 4 12 12 12 12 1 1 1 1 
1 1 20 20 20 20 20 20 20 20 20 1 1 1 1 1 1 1 1 1 1 1 1 1 4 4 4 4 4 4 4 4 4 4 4 4 1 1 1 1 
1 1 20 20 20 20 20 20 20 20 20 20 20 20 20 1 1 1 1 1 1 1 1 1 4 4 4 4 4 4 4 4 4 4 4 4 1 1 1 1 
1 1 20 20 20 20 20 20 20 20 20 20 20 20 20 1 1 1 13 12 1 1 1 1 4 4 4 4 4 4 4 4 4 4 4 4 1 1 1 1 
1 1 20 20 20 20 20 20 20 20 20 20 20 20 20 20 20 1 12 12 1 1 1 1 4 4 4 4 4 4 4 4 4 4 4 4 1 1 1 1 
1 1 20 20 20 20 20 20 20 20 20 20 20 20 20 20 20 1 12 12 12 12 1 1 4 4 4 4 4 4 4 4 4 4 4 4 1 1 1 1 
1 1 1 1 1 1 20 20 20 20 20 1 1 0 0 1 1 1 12 12 12 13 1 1 12 12 12 12 12 12 12 12 12 12 12 12 12 12 1 1 
1 1 1 1 1 1 20 20 20 20 20 1 12 12 12 12 12 12 12 12 12 12 12 12 12 12 12 12 12 12 12 12 12 1 12 12 12 12 1 1 
1 1 1 1 1 1 1 1 20 20 20 1 12 12 12 12 12 12 12 12 12 12 12 12 12 12 12 12 12 12 12 12 12 12 12 12 12 12 1 1 
1 1 1 1 1 1 1 1 20 20 20 1 12 12 12 12 12 12 12 12 12 12 12 12 12 12 12 12 12 12 12 12 12 12 12 12 12 12 1 1 
1 1 1 1 1 1 1 1 20 20 20 1 12 12 12 12 12 12 12 12 12 12 12 12 1 1 12 12 12 12 12 12 12 12 12 12 12 12 1 1 
1 1 1 1 1 1 1 1 20 20 20 1 12 12 12 12 12 12 12 12 12 12 12 12 1 1 1 1 12 12 12 12 12 12 12 12 12 12 1 1 
1 1 1 1 1 1 1 1 20 20 20 20 20 20 20 20 1 12 12 12 12 12 12 12 1 1 1 1 12 12 12 12 12 12 12 13 1 1 1 1 
1 1 1 1 1 1 1 1 20 20 20 20 20 20 20 20 1 12 12 12 12 12 12 12 1 1 1 1 12 12 1 12 12 12 12 12 1 1 1 1 
28 28 28 28 28 28 1 20 20 20 20 20 20 20 20 20 20 20 20 20 20 20 20 1 12 12 1 1 12 12 12 12 12 12 12 12 1 1 1 1 
1 1 1 1 1 1 1 21 20 20 20 20 20 20 20 20 20 20 20 1 1 1 1 1 12 12 12 12 12 12 12 12 12 12 12 12 1 1 1 1 
1 1 1 1 1 1 1 20 20 20 20 20 20 20 20 20 20 20 20 1 1 1 1 1 12 12 12 12 12 1 12 12 12 12 12 12 1 1 1 1 
1 1 1 1 1 1 1 20 20 20 20 20 20 20 20 20 20 20 20 20 20 20 20 20 20 20 20 1 12 12 12 12 12 12 12 12 1 1 1 1 
1 1 1 1 1 1 1 20 21 20 20 20 20 20 20 20 20 20 20 20 20 20 20 20 20 20 20 1 12 12 12 12 12 12 12 12 1 1 1 1 
28 29 28 28 28 28 28 28 28 28 28 28 28 28 28 28 1 20 20 20 20 20 20 20 21 1 1 1 12 12 12 12 12 12 12 12 1 1 1 1 
28 28 28 28 28 28 28 28 28 28 28 28 28 28 28 28 1 1 1 20 20 20 20 20 20 1 1 1 12 12 12 12 12 12 12 12 1 1 1 1 
28 28 28 28 28 28 28 28 28 28 28 28 28 28 28 28 1 1 1 20 20 20 20 1 1 1 1 1 12 12 12 1 12 12 12 12 1 1 1 1 
29 28 28 28 28 28 28 28 28 28 28 28 28 28 28 28 1 1 1 20 20 20 20 1 1 1 1 1 12 12 12 12 12 12 12 12 1 1 1 1 
28 28 28 28 28 28 28 28 28 28 28 1 1 0 0 1 1 1 1 20 20 20 20 1 1 1 1 1 12 12 12 12 12 12 12 12 1 1 1 1 
1 1 1 1 28 28 28 28 28 28 29 1 20 20 20 20 20 20 20 20 20 20 20 1 1 1 1 1 12 12 12 12 12 12 1 1 1 1 1 1 
1 1 1 1 28 28 28 28 28 28 28 1 20 20 20 20 20 20 20 20 20 20 20 1 1 1 1 1 12 12 12 12 12 12 1 1 1 1 1 1 
1 1 1 1 1 1 28 28 28 28 28 1 21 20 20 20 20 20 20 20 20 20 20 1 1 1 1 1 1 1 1 1 1 1 1 1 1 1 1 1 
1 1 1 1 1 1 28 28 28 28 28 1 20 20 21 20 20 1 1 1 1 0 0 1 1 1 1 1 1 1 1 1 1 1 1 1 1 1 1 1 
28 1 1 1 1 1 1 28 28 28 28 1 1 1 1 1 1 1 12 12 12 12 12 12 1 1 1 1 1 1 1 1 1 1 1 1 1 1 1 1 
29 1 1 1 1 1 1 28 28 28 28 1 1 12 12 12 12 12 12 12 12 12 12 12 1 1 1 1 1 1 1 1 1 1 1 1 1 1 1 1 
28 1 1 1 1 1 1 28 28 28 28 1 1 1 1 1 1 12 12 12 12 12 12 12 1 1 1 1 1 1 1 1 1 1 1 1 1 1 1 1 
29 1 1 1 1 1 1 28 28 28 28 1 1 1 1 1 1 12 12 12 12 12 12 12 1 1 1 1 1 1 1 1 1 1 1 1 1 1 1 1 
