Connections;left:SAFARI ZONE (26.3);up:SAFARI ZONE (26.12);
Exits;
1 1 1 1 1 1 12 12 12 1 1 1 1 1 1 1 1 1 1 1 1 1 1 1 1 1 1 12 12 12 12 12 12 1 12 1 1 1 1 1 
1 1 1 1 1 1 12 12 12 1 1 1 1 1 1 1 1 1 1 1 1 1 1 1 1 1 1 12 12 12 12 12 12 1 12 1 1 1 1 1 
1 1 1 1 1 1 12 12 12 1 1 1 1 1 1 1 1 1 1 1 1 1 1 12 12 12 12 12 12 12 12 12 12 1 12 1 1 1 1 1 
1 1 1 1 1 1 12 12 12 1 1 1 1 1 1 1 1 1 1 1 1 1 1 12 12 12 12 12 12 12 12 12 12 1 12 1 1 1 1 1 
1 1 1 1 1 1 12 12 12 12 12 12 12 1 1 1 1 1 1 12 12 12 12 12 12 12 12 12 12 12 12 12 12 1 1 1 1 1 1 1 
1 1 1 1 1 1 12 12 12 12 12 12 12 1 1 1 1 1 1 12 12 12 12 12 12 12 12 12 4 4 4 4 1 1 4 4 4 4 4 4 
1 1 1 1 1 1 12 12 12 12 12 12 12 12 12 12 12 12 12 12 12 12 12 12 12 12 12 4 4 4 4 4 1 1 4 4 4 4 4 4 
1 1 1 1 1 1 12 12 12 12 12 12 12 12 12 12 12 12 12 12 12 12 12 12 12 4 4 4 4 4 1 1 12 12 12 12 12 12 12 12 
1 1 1 1 12 12 12 12 12 12 12 12 12 12 12 12 12 12 12 12 12 12 12 4 4 4 4 4 4 4 1 1 1 1 1 1 1 1 1 1 
1 1 1 1 12 12 12 12 12 12 12 12 12 12 12 12 12 12 12 12 12 4 4 4 4 4 4 4 12 12 1 1 1 1 1 1 1 1 1 1 
1 1 1 1 1 1 12 12 12 12 12 12 12 12 12 12 12 12 12 12 12 4 4 4 4 4 12 12 12 12 1 1 1 1 1 1 1 1 1 1 
1 1 1 1 1 1 12 12 12 12 12 12 12 12 12 12 12 12 12 12 12 4 4 4 4 4 12 12 12 1 12 12 1 1 1 1 1 1 1 1 
1 1 1 1 1 1 12 12 12 12 12 12 12 12 12 12 12 12 12 12 12 4 4 4 12 12 12 12 12 12 12 12 1 1 1 1 1 1 1 1 
1 1 1 1 1 1 12 12 12 12 12 12 12 12 12 12 12 12 12 12 12 4 4 4 12 12 12 12 12 12 12 12 1 1 1 1 1 1 1 1 
1 1 1 1 1 1 12 12 12 12 12 12 12 12 12 12 12 12 12 12 12 4 4 4 12 12 12 12 12 12 12 12 1 1 1 1 1 1 1 1 
1 1 1 1 1 1 12 12 12 12 12 12 12 12 12 12 12 12 12 12 12 4 4 4 12 12 12 12 12 12 12 12 1 1 1 1 1 1 1 1 
12 12 12 12 12 12 12 12 12 12 12 12 12 12 1 1 1 1 12 12 1 4 4 4 1 12 12 1 1 1 1 1 1 1 1 1 1 1 1 1 
12 12 12 12 12 12 12 12 12 12 12 12 12 12 1 1 1 1 0 0 1 4 4 4 1 1 1 1 1 1 1 1 1 1 1 1 1 1 1 1 
1 1 1 1 12 12 12 12 12 12 12 12 1 1 1 1 1 12 12 12 1 4 4 4 1 1 1 1 1 12 12 1 1 1 1 1 1 1 1 1 
1 1 1 1 12 12 12 12 12 12 12 12 1 1 1 1 1 12 12 12 1 4 4 4 4 12 12 12 12 12 12 1 1 1 1 1 1 1 1 1 
1 1 1 1 12 12 12 12 12 12 12 12 1 1 1 1 1 12 12 12 1 4 4 4 4 12 12 12 12 12 12 12 12 1 1 1 1 1 1 1 
1 1 1 1 12 12 12 12 12 12 12 12 1 1 1 1 1 12 12 12 1 4 4 4 4 1 12 12 12 12 12 12 12 1 1 1 1 1 1 1 
1 1 1 12 12 12 12 12 12 12 12 12 1 1 1 1 1 12 12 12 1 4 4 4 4 12 12 12 12 12 12 1 1 1 1 1 1 1 1 1 
1 1 1 12 12 12 12 12 12 12 12 12 1 1 1 1 1 12 12 12 1 4 4 4 4 4 4 4 4 4 4 1 1 1 1 1 1 1 1 1 
1 1 1 12 12 12 12 12 12 12 12 12 1 1 1 1 1 12 12 12 1 4 4 4 4 4 4 4 4 4 4 1 1 4 4 4 4 4 4 4 
1 1 1 12 12 12 12 12 12 12 12 12 1 1 1 12 12 12 12 1 1 4 4 4 4 4 4 4 4 4 4 1 1 4 4 4 4 4 4 4 
1 1 1 1 1 1 1 12 12 12 12 12 1 1 1 12 12 12 12 1 4 4 4 4 4 4 4 4 4 4 4 4 12 1 1 1 1 1 1 1 
1 1 1 1 1 1 1 12 12 12 12 12 1 1 1 12 12 12 1 1 4 4 4 4 4 4 4 4 4 4 4 4 4 1 1 1 1 1 1 1 
1 1 1 1 1 1 1 1 1 1 1 1 1 1 1 12 12 12 1 12 12 4 4 4 4 4 4 4 4 4 4 4 4 1 1 1 1 1 1 1 
1 1 1 1 1 0 1 1 1 1 1 1 1 1 1 12 12 1 1 12 12 12 4 4 4 4 4 4 4 4 4 4 4 1 1 1 1 1 1 1 
1 1 1 1 1 1 1 1 1 1 1 1 1 12 12 12 12 12 12 12 12 12 12 4 4 4 4 4 4 4 4 4 4 1 1 1 1 1 1 1 
1 1 1 1 1 1 12 1 1 1 1 1 1 12 12 12 12 12 12 12 12 12 12 12 4 4 4 4 4 4 12 12 12 1 1 1 1 1 1 1 
1 13 1 1 1 1 1 1 1 1 1 1 12 12 12 12 0 12 12 12 12 12 12 12 12 4 4 4 4 4 12 12 12 1 1 1 1 1 1 1 
1 13 1 1 1 1 1 1 1 1 1 1 12 12 12 12 12 12 12 1 12 12 0 12 12 12 4 4 4 4 12 0 0 1 1 1 1 1 1 1 
1 13 1 1 1 1 1 1 1 1 1 1 1 1 1 1 1 1 12 12 12 12 12 12 12 12 12 12 12 12 12 12 12 1 1 1 1 1 1 1 
1 13 1 1 1 1 1 1 1 1 1 1 1 1 1 1 1 1 12 12 12 12 12 12 12 12 12 12 12 12 12 12 12 1 1 1 1 1 1 1 
1 13 1 1 1 1 1 1 1 1 1 1 1 1 1 1 1 1 12 0 12 12 12 12 12 12 12 0 12 12 12 0 12 1 1 1 1 1 1 1 
1 13 1 1 1 1 1 1 1 1 1 1 1 1 1 1 1 1 12 12 12 0 12 12 12 12 12 12 12 12 12 12 12 1 1 1 1 1 1 1 
1 13 1 1 1 1 1 1 1 1 1 1 1 1 1 1 1 1 1 1 1 1 1 1 1 1 1 1 1 1 1 1 1 1 1 1 1 1 1 1 
1 13 1 1 1 1 1 1 1 1 1 1 1 1 1 1 1 1 1 1 1 1 1 1 1 1 1 1 1 1 1 1 1 1 1 1 1 1 1 1 
