Connections;left:SAFARI ZONE (26.0);down:SAFARI ZONE (26.3);right:SAFARI ZONE (26.12);
Exits;
12 1 1 1 1 1 1 1 1 12 12 12 1 1 1 1 1 1 1 1 1 1 1 1 1 1 1 1 1 1 12 12 12 12 12 12 12 12 12 12 
1 1 12 12 1 1 1 1 1 1 1 1 1 12 12 12 1 1 1 1 1 1 1 1 12 12 12 12 12 1 1 1 1 1 1 12 12 12 12 12 
1 1 1 1 1 1 1 1 1 1 1 1 1 1 1 1 1 12 12 12 12 12 12 1 1 1 1 12 12 12 12 12 12 12 1 12 12 12 12 12 
12 12 1 1 1 1 12 1 1 1 1 1 1 1 1 1 12 12 12 12 12 12 12 12 12 12 1 1 1 12 12 12 12 12 1 1 12 12 12 12 
1 1 1 12 12 1 1 1 12 1 1 1 1 1 12 1 1 1 1 1 1 1 1 1 1 1 1 12 1 1 1 1 1 1 12 1 12 12 12 12 
1 1 1 1 1 1 1 1 1 1 12 12 12 1 1 1 1 1 1 1 1 1 1 1 1 12 1 1 1 1 1 12 12 1 12 1 12 12 12 12 
12 12 12 12 12 12 1 12 12 12 12 12 12 12 12 12 13 12 12 12 12 12 12 12 1 1 1 1 1 12 1 12 12 1 12 1 1 12 12 12 
1 1 1 1 1 1 1 12 12 12 12 12 12 12 12 12 12 12 12 12 12 12 12 12 12 12 12 12 1 1 1 12 12 1 12 12 1 12 12 12 
1 1 1 1 1 1 12 12 12 12 12 12 12 12 12 12 12 12 12 12 12 12 12 12 12 12 12 12 12 1 1 12 12 1 12 12 1 1 1 12 
1 1 1 1 1 1 12 12 12 12 12 12 12 12 12 12 12 12 12 12 12 12 12 12 12 12 12 12 12 1 1 12 12 1 1 12 12 12 1 12 
1 1 1 1 12 12 12 12 12 12 12 12 12 12 12 12 12 12 12 12 12 12 12 12 12 12 12 12 12 1 1 1 12 12 1 12 12 12 1 12 
1 1 1 1 12 12 12 12 12 12 12 12 12 12 12 12 12 12 12 12 12 12 12 12 12 12 12 13 12 1 12 1 12 12 1 12 12 12 1 1 
1 1 1 1 12 12 12 12 12 12 12 12 12 12 12 12 12 12 12 12 12 12 12 12 12 12 12 12 12 1 1 1 12 12 1 1 1 12 12 12 
1 1 1 1 12 12 12 12 12 12 12 12 12 12 12 12 12 12 13 12 12 12 12 12 12 12 12 12 12 12 1 1 12 12 12 12 1 12 12 12 
1 1 1 1 12 12 12 12 12 12 12 12 12 12 12 12 12 12 12 12 12 12 12 12 12 12 12 12 12 12 1 1 1 12 12 12 1 1 1 1 
1 1 1 1 12 12 12 12 12 12 12 12 12 12 12 12 12 12 12 12 12 12 12 12 12 12 12 12 12 12 1 1 1 12 12 12 12 12 12 12 
1 1 1 1 12 12 12 12 12 12 12 12 12 1 20 20 20 20 20 20 20 20 1 12 12 12 12 12 12 12 12 1 1 12 12 12 12 12 12 12 
1 1 1 1 12 12 12 12 12 12 12 1 20 20 20 20 20 20 20 20 20 20 1 12 12 12 12 12 12 12 12 1 1 1 1 12 12 12 12 12 
1 1 12 12 12 12 12 12 12 12 12 1 20 20 20 20 20 20 20 20 20 20 1 12 1 12 12 12 12 12 12 1 1 1 1 1 1 1 1 1 
1 1 12 12 12 12 12 12 12 1 20 20 20 20 20 20 20 20 20 20 20 20 20 20 20 1 12 12 12 12 12 12 12 1 1 12 12 1 1 1 
1 1 12 12 12 12 12 1 20 20 20 20 20 20 20 20 20 20 20 20 20 20 20 20 20 1 12 12 12 12 12 12 12 12 1 1 1 1 1 1 
1 1 1 12 12 12 12 1 20 20 20 20 20 20 20 20 20 20 20 1 1 1 20 1 20 1 12 12 12 12 12 12 1 12 1 1 1 1 1 1 
1 1 12 12 12 12 12 1 20 20 20 20 20 20 1 20 20 20 20 1 20 20 20 1 1 1 1 12 12 12 12 12 12 12 1 1 1 1 1 1 
1 1 12 12 12 12 12 1 20 20 20 20 20 20 20 20 20 20 1 1 1 1 0 1 1 1 12 12 12 12 12 12 12 12 1 1 1 1 1 1 
1 1 1 1 12 12 12 1 1 0 0 1 1 20 20 20 20 20 1 12 12 12 12 12 12 12 12 12 12 12 12 12 12 12 1 1 1 1 1 1 
1 1 1 1 12 12 12 12 12 12 12 12 1 20 20 20 20 20 1 12 12 12 12 12 12 12 12 12 12 12 12 12 12 12 1 1 1 1 1 1 
1 1 1 1 12 12 12 12 12 12 12 12 1 1 1 20 20 20 20 1 12 12 12 12 12 12 12 12 12 12 12 12 1 12 1 1 1 1 1 1 
1 1 1 1 1 12 12 12 12 12 12 12 1 1 1 20 20 20 20 1 12 12 12 12 12 12 12 12 12 12 12 12 12 12 1 1 1 1 1 1 
1 1 1 1 12 12 12 12 12 12 12 12 1 1 1 20 20 20 20 1 1 12 12 12 12 12 12 12 12 12 12 12 12 12 1 1 1 1 1 1 
1 1 1 1 12 12 12 12 12 12 12 12 1 1 1 20 20 20 20 20 20 20 20 20 20 1 12 12 12 12 12 12 12 12 1 1 1 1 1 1 
1 1 1 1 12 12 12 12 12 12 1 20 20 20 20 20 20 20 20 20 20 20 20 20 20 20 20 20 1 1 1 1 1 1 1 1 1 1 1 1 
1 1 1 1 12 12 12 12 12 12 1 20 20 20 20 20 20 20 20 20 20 20 20 20 20 20 20 20 1 1 1 1 1 1 20 1 1 1 1 1 
1 1 12 12 12 12 12 12 1 20 20 20 20 20 20 20 20 20 20 20 20 20 20 20 20 20 20 20 20 20 20 20 20 1 1 1 1 1 1 1 
1 1 12 12 12 12 12 12 1 20 20 20 20 20 20 20 20 20 20 20 20 20 20 20 20 20 20 20 20 20 20 20 20 1 1 1 1 1 1 1 
1 1 12 12 12 1 12 12 1 20 20 20 20 20 20 20 20 1 1 1 1 1 1 1 1 1 1 20 20 20 20 20 20 1 1 1 1 1 1 1 
1 1 12 12 12 12 12 12 1 20 20 20 20 20 20 20 20 1 1 1 1 1 1 1 1 1 1 20 20 20 20 20 20 1 1 1 1 1 1 1 
1 1 12 12 12 12 12 12 1 20 20 20 20 20 20 20 20 1 1 1 1 1 1 1 1 1 1 1 1 20 20 1 1 1 1 1 1 1 1 1 
1 1 12 12 12 12 12 12 1 20 20 20 20 20 20 20 20 1 1 1 1 1 1 1 1 1 1 1 1 20 20 1 1 1 1 1 1 1 1 1 
1 1 1 1 12 12 12 12 1 1 1 1 1 20 20 1 1 1 1 1 1 1 1 1 1 1 1 1 1 20 20 1 1 1 1 1 1 1 1 1 
1 1 1 1 12 12 12 12 1 1 1 1 1 20 20 1 1 1 1 1 1 1 1 1 1 1 1 1 1 20 20 1 1 1 1 1 1 1 1 1 
