Connections;left:SAFARI ZONE (26.1);down:SAFARI ZONE (26.13);
Exits;
12 1 12 12 12 12 12 12 12 1 1 1 1 1 12 1 1 1 1 12 12 12 12 1 1 1 1 1 12 12 1 12 12 12 1 1 12 12 12 12 
12 1 12 12 12 12 12 12 12 1 1 1 12 1 12 1 12 12 1 1 1 1 1 1 12 12 12 12 12 12 1 1 1 1 1 1 12 12 12 12 
12 1 12 12 12 12 12 12 12 1 12 1 12 1 1 1 1 1 1 1 1 1 1 12 12 12 12 1 1 1 1 1 1 12 1 1 1 1 1 12 
12 1 12 12 12 12 12 12 1 1 12 1 1 1 1 12 1 12 12 12 12 12 1 1 12 12 1 1 12 12 12 12 1 1 1 1 1 12 1 1 
12 1 12 12 12 12 1 1 1 12 12 12 1 1 1 1 1 12 12 12 1 1 1 1 1 1 1 12 1 1 12 12 12 1 12 12 1 1 12 12 
12 1 12 12 1 1 1 12 12 1 1 1 12 12 12 1 1 1 1 1 1 12 1 1 1 1 1 1 1 1 1 1 1 1 1 1 12 1 1 12 
12 1 12 1 1 12 1 1 1 1 12 1 1 1 1 1 12 12 12 12 12 12 12 12 12 12 12 12 12 12 12 12 1 12 12 1 1 1 1 12 
12 1 1 1 12 12 1 12 12 12 12 12 12 12 12 12 12 1 1 1 1 1 1 1 1 1 1 1 1 1 12 12 1 12 12 12 1 1 1 12 
12 1 1 1 1 12 1 12 12 12 12 12 12 12 12 1 1 1 12 12 12 12 12 12 12 12 12 12 12 1 12 12 1 1 1 12 1 1 1 12 
12 12 1 1 1 12 1 12 12 12 12 12 12 12 12 1 12 12 12 12 12 12 12 12 12 12 12 12 12 1 0 0 1 1 1 12 1 1 1 12 
1 1 1 12 1 12 1 12 12 12 12 12 12 12 1 1 12 0 0 0 12 12 12 12 12 0 0 0 0 12 12 12 12 1 1 12 1 1 1 12 
1 1 1 12 1 1 1 12 12 12 12 12 12 12 1 12 0 0 0 0 12 12 12 12 12 0 0 0 0 12 12 12 12 1 1 12 1 1 1 1 
12 1 1 12 1 1 12 12 12 12 12 12 12 12 1 12 0 0 12 12 12 12 12 12 12 12 12 12 12 12 12 12 12 1 1 12 1 1 12 1 
12 1 1 12 1 1 12 12 12 12 12 12 12 12 1 12 0 0 12 1 1 1 1 1 1 1 0 0 1 12 12 12 12 1 1 12 1 1 12 12 
1 1 1 12 1 1 12 12 12 12 12 12 12 1 1 12 0 0 12 1 1 1 1 1 1 1 12 12 1 1 12 12 12 1 1 12 1 1 1 12 
12 12 1 12 1 1 1 1 1 1 1 1 12 1 12 12 12 12 12 1 1 1 1 1 1 1 0 0 12 1 1 1 12 1 1 12 1 12 1 1 
12 12 1 1 1 12 1 12 12 12 12 1 12 1 12 12 1 1 1 1 1 1 1 1 0 0 0 0 12 12 12 1 12 1 1 12 1 12 12 12 
12 12 12 12 1 12 1 12 12 12 12 1 12 1 12 12 1 12 12 12 1 1 1 1 0 0 0 12 12 12 12 1 12 1 1 1 1 1 12 12 
1 1 1 1 1 1 1 1 1 1 1 1 1 1 12 12 1 12 0 0 0 0 0 0 0 0 12 12 12 12 12 1 12 1 12 1 12 1 1 1 
1 1 1 1 12 12 12 12 12 12 12 12 12 12 12 12 1 12 0 0 0 0 0 0 0 12 12 12 12 12 12 1 1 1 1 1 1 1 1 1 
1 1 1 1 12 12 12 12 12 12 12 12 12 12 1 1 1 12 12 12 12 12 12 12 12 12 12 12 12 12 12 12 1 12 1 1 1 1 1 1 
1 1 1 1 12 12 12 12 12 12 12 12 1 1 1 12 12 12 12 12 12 12 12 12 12 12 12 12 12 12 12 12 1 1 1 1 1 1 1 1 
1 1 1 1 12 1 12 12 12 12 1 1 1 12 12 12 12 12 12 1 0 0 0 1 1 1 12 12 12 12 12 12 12 1 1 1 1 1 1 1 
1 1 1 1 12 12 12 12 12 12 1 12 12 12 0 0 12 1 1 1 12 12 12 12 12 1 1 12 12 12 12 12 12 1 1 1 1 1 1 1 
1 1 1 1 12 12 12 12 12 12 1 12 12 12 0 0 12 1 12 12 0 0 12 12 12 12 1 1 12 12 12 12 12 1 1 1 1 1 1 1 
1 1 1 1 12 12 12 12 12 12 1 12 12 12 0 0 12 1 12 12 0 0 12 12 12 12 12 1 12 12 12 12 12 1 1 1 1 1 1 1 
1 1 1 1 1 1 1 1 1 1 1 12 12 12 0 0 12 1 12 12 0 0 0 12 12 12 12 1 12 12 12 12 12 1 1 1 1 1 1 1 
1 1 1 1 1 12 12 12 12 12 12 0 0 0 0 12 12 1 12 12 12 0 0 12 12 12 12 1 12 12 12 12 12 1 1 1 1 1 1 1 
1 1 12 12 1 12 12 12 12 12 12 0 0 0 12 12 12 1 12 12 12 12 0 0 12 12 12 1 12 12 12 12 12 1 1 1 1 1 1 1 
1 1 12 12 1 12 12 12 12 12 12 12 0 0 12 12 12 1 12 12 12 12 0 0 0 12 12 1 1 12 12 12 12 1 1 1 1 1 1 1 
1 1 1 1 1 12 12 12 12 12 12 12 12 12 12 12 1 1 12 12 12 12 0 0 0 12 12 1 1 12 12 12 12 1 1 1 1 1 1 1 
1 1 1 1 1 12 12 12 12 12 12 12 12 12 12 1 1 12 12 12 12 12 12 0 0 0 12 12 1 12 12 12 1 1 1 1 1 1 1 1 
1 1 1 1 1 1 1 12 12 12 12 12 12 1 1 1 12 12 12 12 12 12 12 12 0 0 12 12 1 1 1 1 12 12 12 1 1 1 1 1 
1 1 1 1 12 12 1 1 1 1 1 1 1 1 12 12 0 0 0 0 0 0 0 0 0 0 0 0 12 12 1 1 1 1 12 1 1 1 1 1 
1 1 1 1 1 1 12 12 0 0 0 0 0 0 0 0 0 0 0 0 0 0 0 0 0 0 0 0 12 0 0 0 12 1 12 1 1 1 1 1 
1 1 1 1 1 1 12 0 0 0 0 0 0 0 0 0 0 12 12 12 12 12 12 12 12 12 12 12 12 0 0 0 12 1 1 1 1 1 1 1 
1 1 1 1 1 1 12 0 0 0 0 12 12 0 0 12 12 1 1 1 1 1 1 1 1 1 1 12 12 12 12 12 12 1 12 1 1 1 1 1 
1 1 1 1 1 1 12 0 0 12 12 12 12 12 12 12 12 1 1 1 1 1 1 1 1 1 1 12 12 12 12 12 12 1 12 1 1 1 1 1 
1 1 1 1 1 1 12 0 0 1 1 1 1 1 1 1 1 1 1 1 1 1 1 1 1 1 1 12 12 12 12 12 12 1 12 1 1 1 1 1 
1 1 1 1 1 1 12 0 0 1 1 1 1 1 1 1 1 1 1 1 1 1 1 1 1 1 1 12 12 12 0 0 12 1 12 1 1 1 1 1 
