Connections;
Exits;ROUTE 120 (0.35);
1 1 1 1 1 1 1 1 1 1 1 1 1 1 1 
1 1 1 1 1 1 1 1 1 1 1 1 1 1 1 
1 1 1 1 1 1 1 1 1 1 1 1 1 1 1 
1 1 1 1 1 12 12 12 12 12 1 1 1 1 1 
1 1 1 1 12 12 12 12 12 12 12 1 1 1 1 
1 1 1 1 12 12 12 12 12 12 12 1 1 1 1 
1 1 1 1 12 12 12 12 12 12 12 1 1 1 1 
1 1 1 1 12 12 12 12 12 12 12 1 1 1 1 
1 1 1 1 4 4 4 4 4 4 4 1 1 1 1 
1 1 1 1 4 4 4 4 4 4 4 4 1 1 1 
1 1 1 4 4 4 4 4 4 4 4 4 1 1 1 
1 1 1 4 4 4 4 4 4 4 4 4 1 1 1 
1 1 1 4 4 4 4 4 4 4 4 4 1 1 1 
1 1 1 4 4 4 4 4 4 4 4 4 1 1 1 
1 1 1 4 4 4 4 4 4 4 4 4 1 1 1 
1 1 1 4 4 4 4 4 4 4 4 4 1 1 1 
1 1 1 4 4 4 4 4 4 4 4 4 1 1 1 
1 1 1 1 1 1 1 1 1 1 1 1 1 1 1 
1 1 1 1 1 1 1 1 1 1 1 1 1 1 1 
1 1 1 1 1 1 1 1 1 1 1 1 1 1 1 
