Connections;
Exits;SEAFLOOR CAVERN (24.28);SEAFLOOR CAVERN (24.31);SEAFLOOR CAVERN (24.33);SEAFLOOR CAVERN (24.34);
1 1 1 1 1 1 1 1 1 1 1 1 1 1 1 1 1 1 
1 1 1 1 1 1 12 1 1 1 1 12 1 1 1 1 1 1 
1 1 1 1 12 12 12 1 1 1 1 12 12 1 1 1 1 1 
1 1 1 1 12 12 12 12 12 12 12 12 12 12 1 1 1 1 
1 1 1 1 12 1 1 12 1 1 12 1 1 12 1 1 1 1 
1 1 1 1 12 1 1 12 1 1 12 1 1 12 1 1 1 1 
1 1 1 12 12 12 12 12 1 1 12 12 12 12 1 1 1 1 
1 1 1 12 12 12 12 12 12 12 12 12 1 1 1 1 1 1 
1 1 1 1 12 1 1 1 1 1 1 1 1 1 1 1 1 1 
1 1 1 12 12 1 1 1 1 1 1 1 1 1 1 1 1 1 
1 1 1 12 12 12 12 1 1 1 1 1 1 1 1 1 1 1 
1 1 1 1 1 1 1 1 1 1 1 1 1 1 1 1 1 1 
