Connections;
Exits;SEAFLOOR CAVERN (24.29);SEAFLOOR CAVERN (24.30);SEAFLOOR CAVERN (24.27);
1 1 1 1 1 1 1 1 1 1 1 1 1 1 1 1 1 1 1 1 1 1 1 1 
1 1 1 1 12 1 1 1 1 1 1 1 1 1 1 1 1 1 1 1 1 1 1 1 
1 1 12 12 12 12 4 4 4 4 4 4 4 4 4 4 4 4 4 4 4 4 1 1 
1 1 12 12 12 12 4 4 4 4 4 4 4 4 4 4 4 4 4 4 4 4 1 1 
1 1 12 12 12 12 4 4 4 4 4 4 4 4 4 4 4 4 4 4 4 4 1 1 
1 1 12 12 12 12 4 4 4 4 4 4 1 1 1 1 1 4 4 4 4 4 1 1 
1 1 4 4 4 4 4 4 4 4 4 1 1 1 1 1 1 1 4 4 4 4 1 1 
1 1 4 4 4 4 4 4 4 4 4 1 1 1 1 1 1 1 4 4 4 4 1 1 
1 1 4 4 4 4 4 4 4 4 4 1 1 1 4 1 1 1 4 4 4 4 1 1 
1 1 4 4 4 4 4 4 4 4 4 4 4 4 4 4 4 4 4 4 4 4 1 1 
1 1 4 4 4 4 4 4 4 4 4 4 4 4 4 4 4 4 4 4 4 4 1 1 
1 1 4 4 4 4 4 4 4 4 4 4 4 4 4 4 4 4 4 4 4 4 1 1 
1 1 4 4 4 4 4 4 4 4 4 4 4 4 4 4 4 4 4 4 4 4 1 1 
1 1 4 4 4 4 4 4 4 4 4 4 4 4 4 4 4 4 4 4 4 4 1 1 
1 1 4 4 4 4 4 4 4 4 4 4 4 4 4 4 4 4 4 4 4 4 1 1 
1 1 4 4 4 4 4 4 4 4 4 4 4 4 4 4 4 4 4 4 4 4 1 1 
1 1 4 4 4 4 4 4 4 4 4 4 4 4 4 4 4 4 4 4 4 4 1 1 
1 1 4 4 4 4 4 4 4 4 4 4 4 4 4 4 4 4 4 4 4 4 1 1 
1 1 4 4 4 4 4 4 4 4 4 4 4 4 4 4 4 4 4 4 4 4 1 1 
1 1 4 4 4 4 4 4 4 4 4 4 4 4 4 4 4 4 4 1 1 1 1 1 
1 1 4 4 4 4 4 4 1 1 12 12 12 1 1 1 4 1 1 1 1 1 1 1 
1 1 1 1 1 1 1 1 1 1 12 12 12 1 1 1 1 1 1 1 1 1 1 1 
1 1 1 1 1 1 1 1 1 1 1 1 1 1 1 1 1 1 1 1 1 1 1 1 
