Connections;
Exits;UNDERWATER (0.53);SEAFLOOR CAVERN (24.28);
1 1 1 1 1 1 1 1 1 1 1 1 1 1 1 1 1 1 1 1 
1 1 1 1 1 1 1 1 1 1 12 1 1 1 1 1 1 1 1 1 
1 1 1 1 1 1 1 1 12 12 12 12 12 1 1 1 1 1 1 1 
1 1 1 1 1 1 12 12 12 12 12 12 12 12 12 1 1 1 1 1 
1 1 1 1 1 1 12 12 12 12 12 12 12 12 12 1 1 1 1 1 
1 1 1 1 12 12 12 12 12 12 12 12 12 12 12 12 1 1 1 1 
1 1 1 1 12 12 12 12 12 12 12 12 12 12 12 12 1 1 1 1 
1 1 1 12 12 12 12 12 12 12 12 12 12 12 12 12 12 12 1 1 
1 1 1 12 12 12 12 12 12 12 12 12 12 12 12 12 12 12 1 1 
1 1 1 12 12 12 12 12 12 12 12 12 12 12 12 12 12 12 1 1 
1 1 1 12 12 12 12 12 12 12 12 12 12 12 12 12 12 12 1 1 
1 1 1 12 12 12 12 4 4 4 4 4 4 4 12 12 12 12 1 1 
1 1 1 12 12 12 4 4 4 4 4 4 4 4 4 12 12 12 1 1 
1 1 1 12 12 4 4 4 4 4 4 4 4 4 4 4 12 12 1 1 
1 1 1 12 12 4 4 4 4 4 4 4 4 4 4 4 12 12 1 1 
1 1 1 12 12 4 4 4 4 4 4 4 4 4 4 4 12 12 1 1 
1 1 1 1 12 4 4 4 4 4 4 4 4 4 4 4 1 1 1 1 
1 1 1 1 1 4 4 4 4 4 4 4 4 4 1 1 1 1 1 1 
1 1 1 1 1 1 1 4 4 4 4 4 4 1 1 1 1 1 1 1 
1 1 1 1 1 1 1 1 1 1 1 1 1 1 1 1 1 1 1 1 
