Connections;
Exits;SEAFLOOR CAVERN (24.27);SEAFLOOR CAVERN (24.32);SEAFLOOR CAVERN (24.29);
0 0 0 0 0 0 0 0 0 0 0 0 0 0 0 0 0 0 0 0 
0 0 1 1 1 1 1 1 1 1 1 1 1 1 1 12 12 12 0 0 
0 0 1 1 1 1 12 1 1 12 12 12 12 12 1 1 12 12 0 0 
0 0 1 1 1 12 12 12 1 12 12 12 12 12 12 1 1 12 0 0 
0 0 1 1 1 12 12 12 1 1 12 1 12 12 12 12 1 12 0 0 
0 0 1 1 1 1 12 12 12 12 12 1 1 12 12 12 1 12 0 0 
0 0 1 1 1 1 13 12 12 12 12 12 1 1 12 12 1 1 0 0 
0 0 1 1 1 1 13 12 12 12 12 12 12 1 12 12 12 1 0 0 
0 0 1 1 1 1 1 1 1 1 1 1 12 1 12 12 12 1 1 0 
0 0 1 1 1 1 1 1 1 1 1 1 12 1 12 12 12 1 1 0 
0 0 1 1 12 12 1 1 1 1 1 1 12 1 1 12 12 12 1 1 
0 0 1 1 12 12 12 12 12 12 12 12 12 12 1 12 12 12 1 1 
0 0 1 1 12 12 1 13 13 13 13 1 12 1 1 12 12 12 12 1 
0 0 1 1 12 12 1 13 13 13 13 1 12 12 1 12 12 12 12 1 
0 0 1 1 12 1 13 13 13 13 13 1 12 12 1 1 1 1 1 1 
0 0 1 1 12 1 13 13 1 1 1 1 12 12 1 1 1 1 1 1 
0 0 1 1 12 1 1 1 1 12 12 12 12 12 1 1 1 1 1 1 
0 0 1 1 12 12 12 12 12 12 12 1 1 1 1 1 1 1 1 1 
0 0 1 1 12 12 12 12 12 12 12 1 1 1 1 1 1 1 1 1 
0 0 1 1 1 1 1 1 1 1 1 1 1 1 1 1 1 1 1 1 
0 0 1 1 1 1 1 1 1 1 1 1 1 1 1 1 1 1 1 1 
