Connections;
Exits;SEAFLOOR CAVERN (24.29);SEAFLOOR CAVERN (24.32);SEAFLOOR CAVERN (24.32);SEAFLOOR CAVERN (24.27);
1 1 1 1 1 1 1 1 1 1 1 1 1 1 1 1 1 1 
1 1 1 1 12 1 1 1 1 1 1 1 1 12 1 1 13 1 
1 1 12 12 12 12 1 1 1 1 1 1 12 12 12 1 13 1 
1 1 12 12 12 12 1 1 1 1 1 1 12 12 12 1 13 1 
1 1 1 1 1 1 1 1 1 1 1 1 12 12 12 1 13 1 
1 1 12 12 12 12 12 12 12 12 1 12 12 12 12 1 1 1 
1 1 12 12 12 12 12 12 12 12 1 12 12 12 12 12 1 1 
1 1 12 12 12 12 12 1 1 1 1 1 12 12 12 12 1 1 
1 1 12 12 12 12 1 1 13 13 13 1 1 12 12 12 1 1 
1 1 12 12 12 12 1 1 1 1 1 1 1 12 12 12 1 1 
1 1 12 12 12 12 1 1 1 12 1 1 1 12 12 12 1 1 
1 1 12 12 12 12 12 1 12 12 12 12 12 12 12 12 1 1 
1 1 1 1 12 12 12 1 12 12 12 12 12 12 1 1 1 1 
1 1 1 1 1 1 1 1 1 1 1 1 1 1 1 1 1 1 
1 1 1 1 1 1 1 1 1 12 12 12 12 12 1 1 1 1 
1 1 1 1 1 1 1 1 1 12 12 12 12 12 1 1 1 1 
1 1 1 1 1 1 1 1 1 1 1 1 1 1 1 1 1 1 
1 1 1 1 1 1 1 1 1 1 1 1 1 1 1 0 1 1 
1 1 1 1 1 1 1 1 1 1 1 1 1 1 1 1 1 1 
