Connections;
Exits;SEAFLOOR CAVERN (24.36);SEAFLOOR CAVERN (24.30);
1 1 1 1 1 1 1 1 1 1 1 
1 1 1 1 1 1 1 1 13 1 1 
1 1 0 1 1 12 1 1 0 1 1 
1 1 1 1 12 12 12 1 1 1 1 
1 1 1 12 12 12 12 12 1 1 1 
1 1 1 12 12 12 12 12 1 1 1 
1 1 1 12 12 12 12 12 1 1 1 
1 1 1 12 12 12 12 12 1 1 1 
1 1 1 12 12 12 12 12 1 1 1 
1 1 1 12 12 12 12 12 1 1 1 
1 1 1 12 1 1 1 12 1 1 1 
1 1 1 12 12 12 12 12 1 1 1 
1 1 1 12 12 12 12 12 1 1 1 
1 1 1 1 1 1 1 1 1 1 1 
