connections=[
		],
events={
	{
		exits:[SEAFLOOR CAVERN (24.28),SEAFLOOR CAVERN (24.31),SEAFLOOR CAVERN (24.33),SEAFLOOR CAVERN (24.34),		]},
	{
		NPCs:[
			{is_trainer:0,b1:1,b2:0,sprite:87},
			{is_trainer:0,b1:1,b2:0,sprite:87},
			{is_trainer:0,b1:1,b2:0,sprite:87},
			{is_trainer:0,b1:1,b2:0,sprite:87},
			{is_trainer:0,b1:1,b2:0,sprite:87},
			{is_trainer:0,b1:1,b2:0,sprite:86},
			{is_trainer:0,b1:1,b2:0,sprite:86},
			{is_trainer:0,b1:1,b2:0,sprite:87},
		]},
	{
		signs:[
		]},
	{
		triggers:[
		]},

},
[
	[1, 1, 1, 1, 1, 1, 1, 1, 1, 1, 1, 1, 1, 1, 1, 1, 1, 1, ],
	[1, 1, 1, 1, 1, 1, 12, 1, 1, 1, 1, 12, 1, 1, 1, 1, 1, 1, ],
	[1, 1, 1, 1, 12, 12, 12, 1, 1, 1, 1, 12, 12, 1, 1, 1, 1, 1, ],
	[1, 1, 1, 1, 12, 12, 12, 12, 12, 12, 12, 12, 12, 12, 1, 1, 1, 1, ],
	[1, 1, 1, 1, 12, 1, 1, 12, 1, 1, 12, 1, 1, 12, 1, 1, 1, 1, ],
	[1, 1, 1, 1, 12, 1, 1, 12, 1, 1, 12, 1, 1, 12, 1, 1, 1, 1, ],
	[1, 1, 1, 12, 12, 12, 12, 12, 1, 1, 12, 12, 12, 12, 1, 1, 1, 1, ],
	[1, 1, 1, 12, 12, 12, 12, 12, 12, 12, 12, 12, 1, 1, 1, 1, 1, 1, ],
	[1, 1, 1, 1, 12, 1, 1, 1, 1, 1, 1, 1, 1, 1, 1, 1, 1, 1, ],
	[1, 1, 1, 12, 12, 1, 1, 1, 1, 1, 1, 1, 1, 1, 1, 1, 1, 1, ],
	[1, 1, 1, 12, 12, 12, 12, 1, 1, 1, 1, 1, 1, 1, 1, 1, 1, 1, ],
	[1, 1, 1, 1, 1, 1, 1, 1, 1, 1, 1, 1, 1, 1, 1, 1, 1, 1, ],
]
