Connections;
Exits;SEAFLOOR CAVERN (24.35);SEAFLOOR CAVERN (24.34);SEAFLOOR CAVERN (24.33);
13 13 13 13 1 1 1 1 1 1 1 1 1 13 13 13 
13 13 13 13 1 1 1 1 12 1 1 1 1 13 13 13 
13 13 13 1 1 1 12 12 12 12 12 1 1 1 13 13 
13 13 13 1 13 1 12 12 12 12 12 1 1 1 1 1 
13 13 13 1 1 1 12 12 12 12 12 12 1 1 13 1 
13 13 13 1 1 12 12 12 12 12 12 12 12 1 1 1 
13 13 13 1 1 12 12 12 1 1 1 12 12 12 1 1 
13 13 13 1 1 12 12 12 1 13 1 12 12 12 1 1 
1 1 1 1 1 12 12 12 1 13 1 12 12 12 1 1 
1 1 1 1 1 12 12 12 1 13 1 12 12 12 1 1 
1 1 12 12 12 12 12 12 1 1 1 12 12 12 1 1 
1 1 12 12 12 12 12 12 12 12 12 12 12 12 1 1 
1 1 12 12 12 12 12 12 12 12 12 12 12 12 1 1 
1 1 1 1 1 1 12 12 12 12 12 12 12 12 1 1 
1 1 12 12 12 12 12 1 1 1 1 1 1 1 1 1 
1 1 12 12 12 12 12 1 1 1 1 1 1 1 1 1 
1 1 1 1 1 1 1 1 1 13 13 13 13 13 13 13 
