Connections;
Exits;SEALED CHAMBER (24.72);
1 1 1 1 1 1 1 1 1 1 1 1 1 1 1 1 1 1 1 1 1 
1 1 1 1 1 1 1 1 1 1 1 1 1 1 1 1 1 1 1 1 1 
1 1 1 1 1 1 1 1 1 1 12 1 1 1 1 1 1 1 1 1 1 
1 1 1 12 12 12 12 12 12 12 12 12 12 12 12 12 12 12 1 1 1 
1 1 1 12 12 12 12 12 12 12 12 12 12 12 12 12 12 12 1 1 1 
1 1 1 1 1 1 1 1 12 1 1 1 1 1 12 1 1 1 1 1 1 
1 1 1 1 1 1 1 1 12 1 1 1 1 1 12 1 1 1 1 1 1 
1 1 1 12 12 12 12 12 12 12 12 12 12 12 12 12 12 12 1 1 1 
1 1 1 1 1 1 1 1 12 1 1 1 1 1 12 1 1 1 1 1 1 
1 1 1 1 1 1 1 1 12 1 1 1 1 1 12 1 1 1 1 1 1 
1 1 1 12 12 12 12 12 12 12 12 12 12 12 12 12 12 12 1 1 1 
1 1 1 1 1 1 1 1 12 1 1 1 1 1 12 12 12 12 1 1 1 
1 1 1 1 1 1 1 1 12 1 1 1 1 1 12 12 12 12 1 1 1 
1 1 1 12 12 12 12 12 12 12 12 12 12 12 12 12 12 12 1 1 1 
1 1 1 1 1 1 1 1 12 1 1 1 1 1 12 12 12 12 1 1 1 
1 1 1 1 1 1 1 1 12 1 1 1 1 1 12 12 12 12 1 1 1 
1 1 1 12 12 12 12 12 12 12 12 12 12 12 12 12 12 12 1 1 1 
1 1 1 12 12 12 12 12 4 4 4 4 4 12 12 12 12 12 1 1 1 
1 1 1 12 12 12 12 12 4 4 4 4 4 12 12 12 12 12 1 1 1 
1 1 1 12 12 12 12 12 4 4 4 4 4 12 12 12 12 12 1 1 1 
1 1 1 1 1 1 1 1 1 1 1 1 1 1 1 1 1 1 1 1 1 
1 1 1 1 1 1 1 1 1 1 1 1 1 1 1 1 1 1 1 1 1 
1 1 1 1 1 1 1 1 1 1 1 1 1 1 1 1 1 1 1 1 1 
