Connections;
Exits;SEALED CHAMBER (24.71);
1 1 1 1 1 1 1 1 1 1 1 1 1 1 1 1 1 1 1 1 1 
1 1 1 1 1 1 1 1 1 1 1 1 1 1 1 1 1 1 1 1 1 
1 1 1 1 1 1 1 1 1 1 1 1 1 1 1 1 1 1 1 1 1 
1 1 1 1 12 12 12 12 1 1 1 1 1 12 12 12 12 1 1 1 1 
1 1 1 1 12 12 12 12 1 1 1 1 1 12 12 12 12 1 1 1 1 
1 1 1 12 12 12 12 12 12 12 12 12 12 12 12 12 12 12 1 1 1 
1 1 1 12 12 1 1 1 12 12 12 12 12 1 1 1 12 12 1 1 1 
1 1 1 12 12 1 1 1 12 12 12 12 12 1 1 1 12 12 1 1 1 
1 1 1 12 12 1 1 1 12 12 12 12 12 1 1 1 12 12 1 1 1 
1 1 1 12 12 12 12 12 12 12 12 12 12 12 12 12 12 12 1 1 1 
1 1 1 12 12 12 12 12 12 12 12 12 12 12 12 12 12 12 1 1 1 
1 1 1 1 1 1 12 12 12 12 12 12 12 12 12 1 1 1 1 1 1 
1 1 1 1 1 1 12 12 12 12 12 12 12 12 12 1 1 1 1 1 1 
1 1 1 1 1 1 12 12 12 12 12 12 12 12 12 1 1 1 1 1 1 
1 1 1 12 12 12 12 12 12 12 12 12 12 12 12 12 12 12 1 1 1 
1 1 1 12 12 12 12 12 12 12 12 12 12 12 12 12 12 12 1 1 1 
1 1 1 12 12 1 1 1 12 12 12 12 12 1 1 1 12 12 1 1 1 
1 1 1 12 12 1 1 1 12 12 12 12 12 1 1 1 12 12 1 1 1 
1 1 1 1 12 1 1 1 12 12 12 12 12 1 1 1 12 1 1 1 1 
1 1 1 1 12 12 12 12 12 12 12 12 12 12 12 12 12 1 1 1 1 
1 1 1 1 1 1 1 1 1 1 1 1 1 1 1 1 1 1 1 1 1 
1 1 1 1 1 1 1 1 1 1 1 1 1 1 1 1 1 1 1 1 1 
1 1 1 1 1 1 1 1 1 1 1 1 1 1 1 1 1 1 1 1 1 
