connections=[
		],
events={
	
		'exits':[{'name':'SEALED CHAMBER (24.72)','x':10,'y':2},		],
	
		'NPCs':[
		],
	
		'signs':[
			{'x':5,'y':6},
			{'x':5,'y':9},
			{'x':5,'y':12},
			{'x':5,'y':15},
			{'x':11,'y':6},
			{'x':11,'y':9},
			{'x':11,'y':12},
			{'x':11,'y':15},
			{'x':16,'y':6},
			{'x':16,'y':9},
			{'x':10,'y':2},
			{'x':6,'y':6},
			{'x':4,'y':6},
			{'x':4,'y':9},
			{'x':6,'y':9},
			{'x':4,'y':12},
			{'x':6,'y':12},
			{'x':4,'y':15},
			{'x':6,'y':15},
			{'x':10,'y':6},
			{'x':12,'y':6},
			{'x':10,'y':9},
			{'x':12,'y':9},
			{'x':10,'y':12},
			{'x':12,'y':12},
			{'x':10,'y':15},
			{'x':12,'y':15},
			{'x':9,'y':2},
			{'x':11,'y':2},
		],
	
		'triggers':[
		],

},
partial_map=[
	[1, 1, 1, 1, 1, 1, 1, 1, 1, 1, 1, 1, 1, 1, 1, 1, 1, 1, 1, 1, 1, ],
	[1, 1, 1, 1, 1, 1, 1, 1, 1, 1, 1, 1, 1, 1, 1, 1, 1, 1, 1, 1, 1, ],
	[1, 1, 1, 1, 1, 1, 1, 1, 1, 1, 12, 1, 1, 1, 1, 1, 1, 1, 1, 1, 1, ],
	[1, 1, 1, 12, 12, 12, 12, 12, 12, 12, 12, 12, 12, 12, 12, 12, 12, 12, 1, 1, 1, ],
	[1, 1, 1, 12, 12, 12, 12, 12, 12, 12, 12, 12, 12, 12, 12, 12, 12, 12, 1, 1, 1, ],
	[1, 1, 1, 1, 1, 1, 1, 1, 12, 1, 1, 1, 1, 1, 12, 1, 1, 1, 1, 1, 1, ],
	[1, 1, 1, 1, 1, 1, 1, 1, 12, 1, 1, 1, 1, 1, 12, 1, 1, 1, 1, 1, 1, ],
	[1, 1, 1, 12, 12, 12, 12, 12, 12, 12, 12, 12, 12, 12, 12, 12, 12, 12, 1, 1, 1, ],
	[1, 1, 1, 1, 1, 1, 1, 1, 12, 1, 1, 1, 1, 1, 12, 1, 1, 1, 1, 1, 1, ],
	[1, 1, 1, 1, 1, 1, 1, 1, 12, 1, 1, 1, 1, 1, 12, 1, 1, 1, 1, 1, 1, ],
	[1, 1, 1, 12, 12, 12, 12, 12, 12, 12, 12, 12, 12, 12, 12, 12, 12, 12, 1, 1, 1, ],
	[1, 1, 1, 1, 1, 1, 1, 1, 12, 1, 1, 1, 1, 1, 12, 12, 12, 12, 1, 1, 1, ],
	[1, 1, 1, 1, 1, 1, 1, 1, 12, 1, 1, 1, 1, 1, 12, 12, 12, 12, 1, 1, 1, ],
	[1, 1, 1, 12, 12, 12, 12, 12, 12, 12, 12, 12, 12, 12, 12, 12, 12, 12, 1, 1, 1, ],
	[1, 1, 1, 1, 1, 1, 1, 1, 12, 1, 1, 1, 1, 1, 12, 12, 12, 12, 1, 1, 1, ],
	[1, 1, 1, 1, 1, 1, 1, 1, 12, 1, 1, 1, 1, 1, 12, 12, 12, 12, 1, 1, 1, ],
	[1, 1, 1, 12, 12, 12, 12, 12, 12, 12, 12, 12, 12, 12, 12, 12, 12, 12, 1, 1, 1, ],
	[1, 1, 1, 12, 12, 12, 12, 12, 4, 4, 4, 4, 4, 12, 12, 12, 12, 12, 1, 1, 1, ],
	[1, 1, 1, 12, 12, 12, 12, 12, 4, 4, 4, 4, 4, 12, 12, 12, 12, 12, 1, 1, 1, ],
	[1, 1, 1, 12, 12, 12, 12, 12, 4, 4, 4, 4, 4, 12, 12, 12, 12, 12, 1, 1, 1, ],
	[1, 1, 1, 1, 1, 1, 1, 1, 1, 1, 1, 1, 1, 1, 1, 1, 1, 1, 1, 1, 1, ],
	[1, 1, 1, 1, 1, 1, 1, 1, 1, 1, 1, 1, 1, 1, 1, 1, 1, 1, 1, 1, 1, ],
	[1, 1, 1, 1, 1, 1, 1, 1, 1, 1, 1, 1, 1, 1, 1, 1, 1, 1, 1, 1, 1, ],
]
