Connections;
Exits;
1 1 1 1 1 1 1 1 1 1 1 1 
1 1 1 1 1 1 1 1 12 12 12 1 
1 12 12 1 1 1 1 1 12 12 12 1 
1 12 12 1 1 1 1 1 12 12 12 1 
1 12 12 1 1 1 1 1 12 12 12 1 
1 12 12 13 12 12 12 12 12 12 12 1 
1 12 12 12 12 12 12 12 12 12 12 1 
1 12 12 12 12 12 12 12 12 12 12 1 
1 12 12 12 12 12 12 12 12 12 13 1 
1 13 12 12 12 12 12 12 12 12 1 1 
1 1 1 1 1 1 1 1 1 1 1 1 
