Connections;
Exits;
1 1 1 1 1 1 1 1 1 1 1 1 1 1 1 1 1 1 1 1 1 1 1 1 1 1 1 1 1 1 1 1 1 1 1 
1 1 1 1 1 1 1 1 1 1 1 1 1 1 1 1 1 1 1 1 1 1 1 1 1 1 1 1 1 1 1 1 1 1 1 
1 1 1 1 1 1 12 1 1 1 1 1 1 1 1 1 1 1 1 1 1 1 1 1 1 1 1 12 1 1 1 1 1 1 1 
1 1 1 12 12 12 12 12 12 12 12 12 12 12 12 1 1 1 1 1 1 1 1 1 12 12 1 12 12 12 12 12 1 1 1 
1 1 1 12 12 12 12 12 12 12 12 12 12 12 12 1 4 4 4 4 4 4 4 1 12 12 1 12 12 12 12 12 1 1 1 
1 1 1 12 12 12 12 12 12 12 12 12 12 12 12 1 4 4 4 4 4 4 4 1 12 12 1 1 1 1 1 1 1 1 1 
1 1 1 12 12 12 12 1 1 1 1 1 12 1 1 1 4 4 4 4 4 4 4 1 12 12 12 12 12 12 12 12 1 1 1 
1 1 1 12 12 12 12 1 4 4 4 4 4 4 4 4 4 4 4 4 4 4 4 1 12 12 12 12 12 12 12 12 1 1 1 
1 1 1 12 12 12 12 1 4 4 4 4 4 4 4 4 4 4 4 4 4 4 4 1 1 12 1 1 1 1 12 12 1 1 1 
1 1 1 12 12 12 12 1 4 4 4 4 4 4 4 4 4 4 4 4 4 4 4 4 4 4 4 4 4 1 12 12 1 1 1 
1 1 1 1 1 1 1 1 4 4 4 4 4 4 4 4 4 4 4 4 4 4 4 4 4 4 4 4 4 1 12 12 1 1 1 
1 1 1 1 4 4 4 4 4 4 4 4 4 4 4 4 4 4 4 4 4 4 4 4 4 4 4 4 4 1 12 12 1 1 1 
1 1 1 1 4 4 4 4 4 4 4 4 4 4 4 4 4 4 4 4 4 4 4 4 4 4 4 4 4 1 12 12 1 1 1 
1 1 1 1 4 4 4 4 4 4 4 4 4 4 4 4 4 4 4 4 4 4 4 4 4 4 4 4 4 1 12 12 1 1 1 
1 1 1 1 4 4 4 4 4 4 4 4 4 4 4 4 4 4 12 12 12 12 12 12 12 12 12 12 12 1 12 12 1 1 1 
1 1 1 16 16 16 16 16 16 1 4 4 4 4 4 4 4 4 12 12 12 12 12 12 12 12 12 12 12 1 12 12 1 1 1 
1 1 1 16 16 16 16 16 16 1 4 4 4 4 4 4 4 4 12 12 12 12 12 12 12 12 12 12 1 12 12 12 1 1 1 
1 1 1 16 16 16 16 16 0 1 4 4 4 4 4 4 4 4 4 4 4 4 4 12 12 12 12 12 1 12 12 12 1 1 1 
1 1 1 16 16 16 1 1 12 1 4 4 4 4 4 4 4 4 4 4 4 4 4 12 12 12 12 12 1 1 1 1 1 1 1 
1 1 1 16 16 16 1 4 4 4 4 4 4 4 4 4 4 4 4 4 4 4 4 12 12 12 12 12 1 1 1 1 1 1 1 
1 1 1 16 16 16 1 4 4 4 4 4 4 4 4 4 4 4 4 4 4 4 4 12 12 12 1 1 1 1 1 1 1 1 1 
1 1 1 16 16 16 1 4 4 4 4 4 4 4 4 4 4 4 4 4 4 4 4 12 12 12 1 1 1 1 1 1 1 1 1 
1 1 1 16 16 16 1 12 4 4 4 4 4 4 4 4 4 4 4 4 4 4 4 12 12 12 1 1 1 1 1 1 1 1 1 
1 1 1 16 16 16 1 12 12 12 12 12 12 12 12 12 12 12 12 12 12 12 12 12 12 12 1 1 1 1 1 1 1 1 1 
1 1 1 16 16 16 1 12 12 12 12 12 12 12 12 12 12 12 12 12 12 12 12 12 12 12 1 1 1 1 1 1 1 1 1 
1 1 1 16 16 16 1 12 12 12 12 12 12 12 12 12 12 12 12 12 12 12 12 12 12 12 1 1 1 1 1 1 1 1 1 
1 1 1 16 16 16 1 12 12 12 12 12 12 12 12 12 12 12 12 12 12 12 12 12 12 12 1 1 1 1 1 1 1 1 1 
1 1 1 16 16 16 16 16 16 16 16 16 16 1 12 12 12 12 12 12 12 12 12 12 12 12 1 1 1 1 1 1 1 1 1 
1 1 1 16 16 16 16 16 16 16 16 16 16 1 12 12 12 12 12 12 12 12 12 12 12 12 1 1 1 1 1 1 1 1 1 
1 1 1 1 1 1 1 1 1 1 1 1 1 1 12 12 12 12 12 12 12 12 12 12 12 12 1 1 1 1 1 1 1 1 1 
1 1 1 1 1 1 1 1 1 1 1 1 1 1 12 12 12 12 12 12 12 12 12 12 12 12 1 1 1 1 1 1 1 1 1 
1 1 1 1 1 1 1 1 1 1 1 1 1 1 1 1 1 1 1 1 1 1 1 1 1 1 1 1 1 1 1 1 1 1 1 
1 1 1 1 1 1 1 1 1 1 1 1 1 1 1 1 1 1 1 1 1 1 1 1 1 1 1 1 1 1 1 1 1 1 1 
1 1 1 1 1 1 1 1 1 1 1 1 1 1 1 1 1 1 1 1 1 1 1 1 1 1 1 1 1 1 1 1 1 1 1 
1 1 1 1 1 1 1 1 1 1 1 1 1 1 1 1 1 1 1 1 1 1 1 1 1 1 1 1 1 1 1 1 1 1 0 
