Connections;
Exits;SHOAL CAVE (24.49);
1 1 1 1 1 1 1 1 1 1 1 1 1 1 1 1 1 1 1 1 
1 1 1 1 1 1 1 1 1 1 1 1 1 1 1 1 1 1 1 1 
1 1 12 12 12 12 1 12 12 1 12 12 12 12 1 1 1 1 1 1 
1 1 12 1 12 12 12 12 12 12 12 12 12 1 1 1 1 1 1 1 
1 1 12 12 12 12 12 12 12 12 12 1 12 1 1 1 1 1 1 1 
1 1 12 12 12 12 12 12 12 12 12 12 12 12 1 1 1 1 1 1 
1 1 12 12 12 12 12 1 12 12 12 12 12 12 12 1 1 1 1 1 
1 1 12 12 12 12 1 16 16 16 1 12 12 1 1 1 1 1 1 1 
1 1 12 12 12 1 16 16 16 16 1 12 12 12 12 1 1 1 1 1 
1 1 12 12 12 1 16 16 16 16 1 1 1 1 1 1 1 1 1 1 
1 1 12 1 16 16 16 16 16 16 1 12 12 12 12 12 12 12 1 1 
1 1 12 1 16 16 16 16 16 16 1 12 12 12 12 12 12 12 1 1 
1 1 12 1 16 16 16 1 16 16 1 12 12 12 12 12 12 12 1 1 
1 1 12 1 0 1 1 16 16 16 1 12 12 12 12 12 12 12 1 1 
1 1 12 12 12 12 1 16 16 16 1 12 12 12 1 12 12 12 1 1 
1 1 12 12 12 1 1 16 16 16 16 1 12 12 12 12 12 12 1 1 
1 1 1 12 12 12 1 16 16 16 16 16 16 1 12 12 12 12 1 1 
1 1 12 12 1 12 1 16 16 1 16 16 1 1 12 12 12 12 1 1 
1 1 1 12 12 12 1 16 1 16 16 16 16 16 1 12 12 12 1 1 
1 1 1 1 12 12 1 1 1 16 16 16 16 16 1 12 12 12 1 1 
1 1 1 1 12 12 12 12 1 16 16 16 16 16 1 12 12 12 1 1 
1 1 1 1 12 12 12 12 1 1 1 16 16 16 1 12 12 12 1 1 
1 1 1 1 12 1 12 1 12 12 1 16 16 16 1 12 12 12 1 1 
1 1 1 1 1 12 12 12 12 12 1 1 1 1 1 12 12 12 1 1 
1 1 12 12 12 12 12 12 12 12 12 12 12 12 12 12 12 12 1 1 
1 1 12 12 12 12 12 12 12 12 12 12 12 12 12 12 12 12 1 1 
1 1 12 12 1 12 12 12 12 12 1 12 12 12 12 12 12 12 1 1 
1 1 1 1 1 12 12 1 12 12 12 12 12 12 12 12 12 12 1 1 
1 1 1 1 1 1 1 1 1 1 1 12 12 12 12 12 12 12 1 1 
1 1 1 1 1 1 1 1 1 1 1 1 1 1 1 1 1 1 1 1 
