Connections;
Exits;ROUTE 125 (0.40);SHOAL CAVE (24.47);SHOAL CAVE (24.47);SHOAL CAVE (24.47);
1 1 1 1 1 1 1 1 1 1 1 1 1 1 1 1 1 1 1 1 1 1 1 1 1 1 1 1 1 1 1 1 1 1 1 
1 1 1 1 1 1 1 1 1 1 1 1 1 1 1 1 1 1 1 1 1 1 1 1 1 1 1 1 1 1 1 1 1 1 1 
1 1 1 1 1 1 12 1 1 1 1 1 1 1 1 1 1 1 1 1 1 1 1 1 1 1 1 12 1 1 1 1 1 1 1 
1 1 1 12 12 12 12 12 12 12 12 12 12 12 12 1 1 1 1 1 1 1 1 1 12 12 1 12 12 12 12 12 1 1 1 
1 1 1 12 12 12 12 12 12 12 12 12 12 12 12 1 1 1 1 1 1 1 1 1 12 12 1 12 12 12 12 12 1 1 1 
1 1 1 12 12 12 12 12 12 12 12 12 12 12 12 1 1 1 1 12 1 1 1 1 12 12 1 1 1 1 1 1 1 1 1 
1 1 1 12 12 12 12 1 1 1 1 1 12 1 1 1 1 1 12 12 12 1 1 1 12 12 12 12 12 12 12 12 1 1 1 
1 1 1 12 12 12 12 1 1 1 1 1 1 1 1 1 1 1 12 12 12 1 1 1 12 12 12 12 12 12 12 12 1 1 1 
1 1 1 12 12 12 12 1 1 12 12 12 12 12 1 1 1 1 12 12 12 1 1 1 1 12 1 1 1 1 12 12 1 1 1 
1 1 1 12 12 12 12 1 1 12 12 12 12 12 1 12 12 12 12 12 12 1 1 1 1 1 1 1 1 1 12 12 1 1 1 
1 1 1 1 1 1 1 1 1 12 12 12 12 12 1 12 12 12 12 12 12 1 1 1 1 1 1 1 1 1 12 12 1 1 1 
1 1 1 1 1 1 1 1 1 12 12 12 12 12 1 12 12 12 12 12 12 12 12 12 12 12 12 1 1 1 12 12 1 1 1 
1 1 1 1 1 12 12 12 12 12 12 1 12 1 1 12 12 12 12 12 12 12 12 12 12 12 12 1 1 1 12 12 1 1 1 
1 1 1 1 1 12 12 12 12 12 12 1 12 12 12 12 1 1 1 1 1 1 1 1 1 1 1 1 1 1 12 12 1 1 1 
1 1 1 1 1 1 1 1 1 1 1 1 12 12 12 12 1 1 12 12 12 12 12 12 12 12 12 12 12 1 12 12 1 1 1 
1 1 1 16 16 16 16 16 16 1 1 1 12 12 12 12 1 1 12 12 12 12 12 12 12 12 12 12 12 1 12 12 1 1 1 
1 1 1 16 16 16 16 16 16 1 1 1 12 12 12 12 1 1 12 12 12 12 12 12 12 12 12 12 1 12 12 12 1 1 1 
1 1 1 16 16 16 16 16 16 1 1 1 12 12 12 12 1 1 12 1 1 1 1 12 12 12 12 12 1 12 12 12 1 1 1 
1 1 1 16 16 16 1 1 16 1 1 1 12 12 12 12 1 1 12 1 1 1 1 12 12 12 12 12 1 1 1 1 1 1 1 
1 1 1 16 16 16 1 1 1 1 1 1 12 12 12 12 12 12 12 12 12 1 1 12 12 12 12 12 1 1 1 1 1 1 1 
1 1 1 16 16 16 1 1 1 1 1 1 12 12 12 12 12 12 12 12 12 1 1 12 12 12 1 1 1 1 1 1 1 1 1 
1 1 1 16 16 16 1 1 1 12 12 12 12 12 12 12 12 12 12 12 12 1 1 12 12 12 1 1 1 1 1 1 1 1 1 
1 1 1 16 16 16 1 1 1 1 1 1 1 1 1 1 1 1 1 1 1 1 1 12 12 12 1 1 1 1 1 1 1 1 1 
1 1 1 16 16 16 1 12 12 12 12 12 12 12 12 12 12 12 12 12 12 12 12 12 12 12 1 1 1 1 1 1 1 1 1 
1 1 1 16 16 16 1 12 12 12 12 12 12 12 12 12 12 12 12 12 12 12 12 12 12 12 1 1 1 1 1 1 1 1 1 
1 1 1 16 16 16 1 12 12 12 12 12 12 12 12 12 12 12 12 12 12 12 12 12 12 12 1 1 1 1 1 1 1 1 1 
1 1 1 16 16 16 1 12 12 12 12 12 12 12 12 12 12 12 12 12 12 12 12 12 12 12 1 1 1 1 1 1 1 1 1 
1 1 1 16 16 16 16 16 16 16 16 16 16 1 12 12 12 12 12 12 12 12 12 12 12 12 1 1 1 1 1 1 1 1 1 
1 1 1 16 16 16 16 16 16 16 16 16 16 1 12 12 12 12 12 12 12 12 12 12 12 12 1 1 1 1 1 1 1 1 1 
1 1 1 1 1 1 1 1 1 1 1 1 1 1 12 12 12 12 12 12 12 12 12 12 12 12 1 1 1 1 1 1 1 1 1 
1 1 1 1 1 1 1 1 1 1 1 1 1 1 12 12 12 12 12 12 12 12 12 12 12 12 1 1 1 1 1 1 1 1 1 
1 1 1 1 1 1 1 1 1 1 1 1 1 1 1 1 1 1 1 1 1 1 1 1 1 1 1 1 1 1 1 1 1 1 1 
1 1 1 1 1 1 1 1 1 1 1 1 1 1 1 1 1 1 1 1 1 1 1 1 1 1 1 1 1 1 1 1 1 1 1 
1 1 1 1 1 1 1 1 1 1 1 1 1 1 1 1 1 1 1 1 1 1 1 1 1 1 1 1 1 1 1 1 1 1 1 
1 1 1 1 1 1 1 1 1 1 1 1 1 1 1 1 1 1 1 1 1 1 1 1 1 1 1 1 1 1 1 1 1 1 1 
