Connections;
Exits;SHOAL CAVE (24.46);SHOAL CAVE (24.48);SHOAL CAVE (24.48);SHOAL CAVE (24.49);SHOAL CAVE (24.49);SHOAL CAVE (24.49);SHOAL CAVE (24.46);SHOAL CAVE (24.46);
1 1 1 1 1 1 1 1 1 1 1 1 1 1 1 1 1 1 1 1 1 1 1 1 1 1 1 1 1 1 1 1 1 1 1 1 1 1 1 1 1 1 1 1 1 1 
1 1 1 1 1 1 1 1 1 1 1 1 1 1 1 1 1 1 1 1 1 1 1 1 1 1 1 1 1 1 1 1 1 1 1 1 1 1 1 1 1 1 1 1 1 1 
1 1 1 1 1 1 1 1 1 1 1 1 1 1 1 1 1 1 1 1 1 1 1 1 1 1 1 1 1 1 1 1 1 1 1 1 1 16 16 1 1 1 1 1 1 1 
1 1 1 1 1 1 1 1 1 1 1 1 1 1 1 1 1 1 1 1 1 1 1 1 1 1 1 1 1 1 1 1 1 1 1 1 1 16 16 1 1 1 1 1 1 1 
1 1 16 16 16 16 16 1 1 1 1 1 1 1 1 1 1 1 1 1 1 1 1 1 1 1 1 1 1 1 1 1 1 1 1 1 1 16 16 1 12 12 12 12 12 1 
1 1 16 16 16 16 16 16 16 16 60 60 60 60 60 60 60 60 60 60 60 60 60 60 60 60 60 60 60 60 60 60 60 60 16 16 16 16 16 1 12 12 12 12 12 1 
1 1 16 16 16 16 16 16 16 16 60 60 60 60 60 60 60 60 60 60 60 60 60 60 60 60 60 60 60 60 60 60 60 60 16 16 16 16 16 1 1 1 0 1 1 1 
1 1 16 16 16 16 16 1 1 1 20 20 20 20 20 20 20 20 20 20 20 20 20 20 20 20 20 20 20 20 20 20 20 20 1 1 1 16 16 16 16 16 16 16 1 1 
1 1 16 16 16 1 1 1 1 1 20 20 20 20 20 20 20 20 20 20 20 20 20 20 20 20 20 20 20 20 20 20 20 20 1 1 1 16 16 16 16 16 16 16 1 1 
1 1 16 16 16 1 12 12 1 1 20 20 20 20 20 20 20 20 20 20 20 20 20 20 20 20 20 20 20 20 20 20 20 20 1 1 1 1 1 1 1 1 1 1 1 1 
1 1 16 16 16 1 12 12 1 1 20 20 20 1 12 12 12 12 12 12 12 12 12 12 12 12 12 12 12 12 12 12 12 12 12 1 20 20 20 20 20 20 20 1 1 1 
1 1 16 16 16 1 12 12 1 1 20 20 20 1 12 12 12 12 12 12 12 12 12 12 12 12 12 12 12 12 12 12 12 12 12 1 20 20 20 20 20 20 20 1 1 1 
1 1 16 16 16 1 12 12 1 1 20 20 20 1 1 20 20 20 20 20 20 20 20 20 20 20 1 12 12 12 12 12 12 12 12 1 1 0 1 1 1 1 1 1 1 1 
1 1 16 16 16 1 1 12 1 1 20 20 20 1 1 20 20 1 16 16 16 16 16 16 16 1 20 20 1 12 12 1 1 1 12 1 1 1 1 1 1 1 1 1 1 1 
1 1 16 16 16 1 1 1 1 1 20 20 20 1 1 20 20 1 16 16 16 16 16 16 16 1 20 20 1 12 12 1 1 1 12 1 1 1 1 1 1 1 1 1 1 1 
1 1 16 16 16 1 1 1 20 20 20 20 20 1 1 20 20 1 16 16 16 16 16 16 16 1 20 20 1 12 12 1 1 12 12 12 12 12 12 12 1 1 1 1 1 1 
1 1 16 16 16 1 1 1 20 20 20 20 20 1 1 20 20 1 1 1 1 16 16 16 16 1 20 20 1 12 12 1 1 1 1 1 1 1 1 1 1 1 1 1 1 1 
1 1 16 16 16 1 1 1 20 20 20 20 20 1 1 1 0 1 1 1 1 16 16 16 16 1 20 20 1 12 12 12 12 12 12 12 12 12 12 12 12 12 1 1 1 1 
1 1 16 16 16 1 1 1 1 1 1 0 1 1 1 1 1 1 1 1 1 16 16 16 16 1 20 20 1 12 12 12 12 12 12 12 12 12 12 12 12 12 1 1 1 1 
1 1 16 16 16 1 1 1 1 12 12 12 1 1 1 12 1 1 1 1 1 16 16 16 16 1 20 20 1 12 12 12 12 12 12 1 20 20 20 20 20 20 20 1 1 1 
1 1 16 16 16 1 1 1 1 12 12 12 12 12 12 12 12 1 1 1 1 16 16 16 16 1 20 20 1 12 12 12 12 12 12 1 20 20 20 20 20 20 20 1 1 1 
1 1 16 16 16 16 16 16 16 60 60 60 60 60 60 60 60 16 16 16 16 16 16 16 16 1 20 20 1 12 12 12 12 12 12 1 20 20 20 20 20 20 20 1 1 1 
1 1 16 16 16 16 16 16 16 60 60 60 60 60 60 60 60 16 16 16 16 16 16 16 16 1 20 20 1 12 12 12 12 12 12 1 20 20 20 20 20 20 20 1 1 1 
1 1 1 1 1 1 1 1 1 12 12 12 12 12 12 12 12 1 1 1 1 1 16 1 1 1 1 0 1 12 12 12 12 12 12 1 20 1 1 20 20 20 20 1 1 1 
1 1 1 1 1 1 1 1 1 1 1 1 1 12 12 12 12 1 1 1 16 16 16 16 16 16 1 1 1 1 1 1 12 1 1 1 1 1 1 20 20 20 20 1 1 1 
1 1 1 20 20 20 20 20 20 1 12 1 1 12 12 1 1 1 1 1 16 16 16 16 16 16 1 1 1 1 12 1 12 1 1 1 1 1 1 20 20 20 20 1 1 1 
1 1 1 20 20 20 20 20 20 1 12 1 1 12 12 1 1 1 1 1 16 16 16 16 16 16 1 1 1 12 12 12 12 12 12 12 1 1 1 20 20 20 20 1 1 1 
1 1 1 20 20 20 1 1 0 1 12 1 1 12 12 1 1 1 1 1 1 1 1 1 1 1 1 1 1 12 12 12 12 12 12 12 1 1 1 20 20 20 20 1 1 1 
1 1 1 20 20 20 1 12 12 12 12 1 1 1 1 1 1 1 1 1 1 1 1 1 1 1 1 1 1 12 12 12 12 12 12 12 1 1 1 20 20 20 20 1 1 1 
1 1 1 20 20 20 1 12 12 12 12 12 12 12 12 12 12 1 1 1 1 1 1 1 1 1 1 1 1 12 12 12 12 12 12 12 1 1 1 20 20 20 20 1 1 1 
1 1 1 20 20 20 1 12 12 12 12 12 12 12 12 12 12 1 1 1 1 1 1 1 1 1 1 1 1 1 1 1 1 1 1 1 1 1 1 20 20 20 20 1 1 1 
1 1 1 20 20 20 20 20 20 20 20 20 20 20 20 20 20 20 1 1 1 1 1 1 1 1 1 1 1 1 1 1 1 1 1 1 1 1 1 20 20 20 20 1 1 1 
1 1 1 20 20 20 20 20 20 20 20 20 20 20 20 20 20 20 1 1 1 1 1 1 1 1 1 1 1 1 1 1 1 1 1 20 20 20 20 20 20 20 20 1 1 1 
1 1 1 20 20 20 20 20 20 20 20 20 20 20 20 20 20 20 1 1 1 1 1 1 1 1 1 1 1 1 1 1 1 1 1 20 20 20 20 20 20 20 20 1 1 1 
1 1 1 1 1 1 1 1 1 1 1 1 1 1 1 1 1 1 1 1 1 1 1 1 1 1 1 1 1 1 1 1 1 1 1 1 1 1 1 1 1 1 1 1 1 1 
1 1 1 1 1 1 1 1 1 1 1 1 1 1 1 1 1 1 1 1 1 1 1 1 1 1 1 1 1 1 1 1 1 1 1 1 1 1 1 1 1 1 1 1 1 1 
1 1 1 1 1 1 1 1 1 1 1 1 1 1 1 1 1 1 1 1 1 1 1 1 1 1 1 1 1 1 1 1 1 1 1 1 1 1 1 1 1 1 1 1 1 1 
1 1 1 1 1 1 1 1 1 1 1 1 1 1 1 1 1 1 1 1 1 1 1 1 1 1 1 1 1 1 1 1 1 1 1 1 1 1 1 1 1 1 1 1 1 1 
