Connections;
Exits;SKY PILLAR (24.84);
0 0 0 0 0 0 0 0 0 0 0 0 0 0 0 0 0 0 0 0 0 0 0 0 0 0 0 
0 0 0 0 0 0 0 0 0 0 0 0 0 0 0 0 0 0 0 0 0 0 0 0 0 0 0 
0 0 0 0 0 0 0 0 0 0 0 0 0 0 0 0 0 0 0 0 0 0 0 0 0 0 0 
12 12 12 13 12 12 12 13 12 12 12 13 13 13 13 13 13 13 12 12 12 13 12 12 12 13 12 
1 0 0 0 1 12 0 12 1 12 1 12 0 1 12 1 0 0 1 12 0 12 0 1 1 0 0 
12 0 12 12 0 0 0 0 12 1 12 0 1 12 12 12 1 0 12 0 12 0 12 1 1 0 0 
0 0 0 12 0 0 0 0 0 0 1 12 1 12 12 12 1 12 0 0 0 12 1 12 12 0 1 
0 0 0 0 0 0 0 0 0 0 0 1 12 1 12 1 0 0 0 0 0 1 0 0 0 1 0 
0 0 0 12 1 12 0 0 0 12 1 12 1 12 12 1 1 0 0 0 0 0 1 12 1 1 0 
12 0 0 0 12 1 12 12 1 1 12 1 1 12 12 12 1 1 0 1 12 0 0 0 0 0 0 
12 12 0 0 0 12 0 0 12 0 1 12 1 1 12 1 12 12 1 0 0 12 1 12 0 12 0 
0 12 12 0 0 0 12 1 12 1 12 12 12 12 12 12 12 1 12 1 0 0 0 0 0 0 0 
12 12 1 12 1 0 0 12 1 12 12 12 12 1 12 12 12 12 12 12 1 0 12 0 0 12 1 
1 1 1 1 1 1 1 1 1 1 1 12 12 1 1 1 1 1 1 1 1 1 1 1 1 1 1 
1 1 1 1 1 1 1 1 1 1 1 12 12 1 1 1 12 1 1 1 1 1 1 1 1 1 1 
12 1 12 1 12 1 12 1 12 12 1 12 12 12 12 12 12 12 1 12 1 12 1 12 1 12 1 
1 0 0 0 0 0 1 12 12 12 12 12 12 12 12 1 12 1 0 1 1 1 12 0 0 0 0 
0 1 0 0 0 0 0 1 12 12 12 12 1 12 12 12 1 12 0 12 1 0 1 0 1 1 1 
1 1 1 1 1 1 1 1 1 1 1 1 1 1 1 1 1 1 1 1 1 1 1 1 1 1 1 
1 1 1 1 1 1 1 1 1 1 1 1 1 1 1 1 1 1 1 1 1 1 1 1 1 1 1 
1 1 1 1 1 1 1 1 1 1 1 1 1 1 1 1 1 1 1 1 1 1 1 1 1 1 1 
1 1 1 1 1 1 1 1 1 1 1 1 1 1 1 1 1 1 1 1 1 1 1 1 1 1 1 
1 1 1 1 1 1 1 1 1 1 1 1 1 1 1 1 1 1 1 1 1 1 1 1 1 1 1 
1 1 1 1 1 1 1 1 1 1 1 1 1 1 1 1 1 1 1 1 1 1 1 1 1 1 1 
