connections=[
		],
events={
	
		'exits':[{'name':'SKY PILLAR (24.81)','x':11,'y':1},{'name':'SKY PILLAR (24.81)','x':7,'y':1},{'name':'SKY PILLAR (24.84)','x':3,'y':1},		],
	
		'NPCs':[
		],
	
		'signs':[
		],
	
		'triggers':[
		],

},
partial_map=[
	[1, 1, 1, 1, 1, 1, 1, 1, 1, 1, 1, 1, 1, 1, ],
	[1, 1, 1, 12, 1, 1, 1, 12, 1, 1, 1, 12, 1, 1, ],
	[12, 12, 12, 12, 12, 12, 12, 12, 13, 12, 12, 12, 12, 12, ],
	[12, 12, 13, 1, 1, 1, 13, 1, 1, 13, 12, 12, 12, 13, ],
	[1, 1, 12, 12, 12, 12, 12, 12, 12, 12, 13, 12, 12, 12, ],
	[12, 13, 12, 12, 1, 1, 1, 1, 1, 1, 12, 12, 12, 12, ],
	[12, 12, 12, 12, 1, 1, 1, 1, 1, 1, 12, 12, 12, 12, ],
	[12, 12, 1, 12, 1, 1, 1, 1, 1, 1, 12, 12, 13, 12, ],
	[12, 12, 13, 12, 1, 1, 1, 1, 1, 1, 12, 12, 12, 13, ],
	[1, 12, 13, 12, 1, 1, 1, 1, 1, 1, 12, 12, 12, 12, ],
	[1, 12, 12, 12, 1, 1, 1, 1, 1, 1, 12, 12, 12, 12, ],
	[12, 12, 12, 12, 12, 13, 12, 12, 12, 13, 12, 12, 12, 12, ],
	[12, 12, 13, 12, 12, 12, 12, 12, 12, 12, 12, 12, 12, 12, ],
	[12, 12, 12, 12, 12, 12, 12, 13, 12, 12, 12, 12, 12, 12, ],
]
