Connections;
Exits;SKY PILLAR (24.79);SKY PILLAR (24.81);
1 1 1 1 1 1 1 1 1 1 1 1 1 1 
1 1 1 12 1 1 1 1 1 1 12 1 1 1 
12 12 12 12 12 12 12 12 1 12 12 12 12 12 
12 12 12 12 12 1 12 1 1 12 12 12 12 12 
12 12 12 12 12 12 1 12 12 12 1 12 12 12 
12 12 12 12 1 1 1 1 1 1 12 12 12 12 
1 1 12 12 1 1 1 1 1 1 12 12 12 12 
12 12 12 12 1 1 1 1 1 1 12 12 12 1 
12 12 12 12 1 1 1 1 1 1 12 12 12 12 
12 12 12 12 1 1 1 1 1 1 12 12 12 12 
12 12 12 12 1 1 1 1 1 1 12 12 12 12 
12 12 12 1 12 12 12 12 12 1 12 12 12 12 
12 12 1 12 12 12 12 12 12 12 12 12 12 12 
12 12 12 12 12 12 12 12 12 12 12 12 12 1 
