connections=[
		],
events={
	
		'exits':[{'name':'SKY PILLAR (24.79)','x':10,'y':1},{'name':'SKY PILLAR (24.81)','x':3,'y':1},		],
	
		'NPCs':[
		],
	
		'signs':[
		],
	
		'triggers':[
		],

},
partial_map=[
	[1, 1, 1, 1, 1, 1, 1, 1, 1, 1, 1, 1, 1, 1, ],
	[1, 1, 1, 12, 1, 1, 1, 1, 1, 1, 12, 1, 1, 1, ],
	[12, 12, 12, 12, 12, 12, 12, 12, 1, 12, 12, 12, 12, 12, ],
	[12, 12, 12, 12, 12, 1, 12, 1, 1, 12, 12, 12, 12, 12, ],
	[12, 12, 12, 12, 12, 12, 1, 12, 12, 12, 1, 12, 12, 12, ],
	[12, 12, 12, 12, 1, 1, 1, 1, 1, 1, 12, 12, 12, 12, ],
	[1, 1, 12, 12, 1, 1, 1, 1, 1, 1, 12, 12, 12, 12, ],
	[12, 12, 12, 12, 1, 1, 1, 1, 1, 1, 12, 12, 12, 1, ],
	[12, 12, 12, 12, 1, 1, 1, 1, 1, 1, 12, 12, 12, 12, ],
	[12, 12, 12, 12, 1, 1, 1, 1, 1, 1, 12, 12, 12, 12, ],
	[12, 12, 12, 12, 1, 1, 1, 1, 1, 1, 12, 12, 12, 12, ],
	[12, 12, 12, 1, 12, 12, 12, 12, 12, 1, 12, 12, 12, 12, ],
	[12, 12, 1, 12, 12, 12, 12, 12, 12, 12, 12, 12, 12, 12, ],
	[12, 12, 12, 12, 12, 12, 12, 12, 12, 12, 12, 12, 12, 1, ],
]
