Connections;
Exits;SLATEPORT CITY (0.1);SLATEPORT CITY (0.1);SLATEPORT CITY (9.1);
1 1 1 1 1 1 1 1 1 1 1 1 1 1 1 1 1 1 1 1 1 
1 1 1 0 1 1 1 1 1 1 1 1 1 1 1 1 1 1 1 1 1 
1 1 12 12 12 12 1 12 12 12 12 12 12 12 12 12 12 12 12 12 12 
12 12 12 12 12 12 1 12 12 12 12 12 12 12 12 12 12 12 12 12 12 
12 12 12 12 12 12 1 1 1 1 1 1 1 1 1 1 12 12 12 1 1 
1 1 12 12 12 12 1 1 1 1 1 1 1 1 1 1 12 12 12 1 1 
12 12 12 12 1 1 1 1 12 1 1 1 1 1 1 12 12 12 12 1 1 
12 12 12 12 1 1 1 12 12 12 12 1 1 1 1 12 12 12 12 12 12 
1 1 12 12 12 12 1 12 12 12 12 12 1 1 12 12 12 12 12 12 12 
12 12 12 12 12 12 12 12 12 12 12 12 1 1 12 12 12 12 12 12 12 
12 12 12 12 12 12 12 12 12 12 12 12 12 12 12 12 12 12 12 12 12 
1 1 12 12 12 12 1 12 12 12 12 12 12 12 12 12 12 12 1 1 1 
12 12 12 12 12 12 1 1 12 12 1 12 12 12 1 12 12 12 1 1 1 
12 12 12 12 12 12 1 1 1 1 12 12 12 12 12 12 12 12 1 1 1 
12 12 12 12 12 12 1 1 1 1 12 12 12 12 12 12 12 12 12 12 12 
