Connections;
Exits;SLATEPORT CITY (0.1);SLATEPORT CITY (0.1);SLATEPORT CITY (9.8);
1 1 1 1 1 1 1 1 1 1 1 1 1 1 1 1 1 1 1 1 
1 1 1 1 1 1 0 1 1 1 1 1 1 1 1 1 1 1 1 1 
12 12 12 12 12 12 12 12 12 12 12 12 12 12 12 12 12 12 12 12 
12 12 12 12 12 12 12 12 12 12 12 12 12 12 12 12 12 12 12 12 
12 12 1 12 12 12 12 12 12 12 12 12 12 12 12 13 12 12 13 12 
12 12 12 12 12 12 12 12 12 12 12 12 12 12 12 12 12 12 12 12 
12 12 12 12 12 13 13 13 13 12 12 13 13 13 13 12 12 12 12 12 
12 12 1 12 12 13 12 12 13 12 12 13 12 12 13 12 12 12 13 12 
12 12 12 12 12 13 12 12 13 0 0 13 12 12 13 12 12 12 12 12 
