Connections;
Exits;SLATEPORT CITY (0.1);SLATEPORT CITY (0.1);
1 1 1 1 1 1 1 1 1 1 1 1 1 1 
1 1 1 1 1 1 1 1 1 1 1 1 1 1 
1 1 1 1 12 12 12 12 12 12 1 1 1 1 
12 12 12 12 12 12 12 12 12 12 12 12 12 12 
12 12 12 12 12 12 12 12 12 12 12 12 12 12 
12 12 12 0 0 16 16 16 16 0 0 12 12 12 
12 12 12 16 0 1 1 1 1 0 16 12 12 12 
12 12 12 16 0 1 1 1 1 0 16 12 12 12 
12 12 12 0 12 12 12 12 12 12 0 12 12 12 
12 12 12 12 12 12 12 12 12 12 12 12 12 12 
1 12 12 12 12 12 0 0 12 12 12 12 12 1 
