Connections;
Exits;SLATEPORT CITY (0.1);SLATEPORT CITY (0.1);
1 1 13 13 13 13 13 13 13 13 13 1 1 
1 1 1 1 1 1 0 1 1 1 1 1 1 
1 12 1 1 12 12 12 12 12 1 1 1 1 
1 12 1 0 12 12 12 12 12 0 1 13 1 
1 12 1 1 1 1 12 1 1 1 1 13 1 
12 12 1 1 1 1 12 1 1 1 1 12 12 
12 12 12 12 12 12 12 12 12 12 12 12 12 
12 12 12 12 12 12 12 12 12 12 12 12 12 
1 12 12 12 12 12 12 12 12 12 12 12 1 
1 1 12 12 12 12 0 0 12 12 12 1 1 
