connections=[
		],
events={
	
		'exits':[{'name':'SLATEPORT CITY (0.1)','x':11,'y':14},{'name':'SLATEPORT CITY (0.1)','x':12,'y':14},{'name':'SLATEPORT CITY (0.1)','x':19,'y':15},{'name':'SLATEPORT CITY (0.1)','x':20,'y':15},		],
	
		'NPCs':[
			{'is_trainer':0,'b1':8,'b2':0,'sprite':'45','x':8,'y':10},
			{'is_trainer':0,'b1':9,'b2':0,'sprite':'49','x':4,'y':12},
			{'is_trainer':0,'b1':10,'b2':0,'sprite':'17','x':1,'y':12},
			{'is_trainer':0,'b1':1,'b2':0,'sprite':'46','x':6,'y':13},
			{'is_trainer':0,'b1':10,'b2':0,'sprite':'140','x':8,'y':9},
			{'is_trainer':0,'b1':10,'b2':0,'sprite':'117','x':7,'y':10},
			{'is_trainer':0,'b1':9,'b2':0,'sprite':'195','x':8,'y':10},
			{'is_trainer':0,'b1':10,'b2':0,'sprite':'141','x':7,'y':9},
		],
	
		'signs':[
		],
	
		'triggers':[
			{'x':8,'y':11,'flag':16544,'scriptPointer':2148795},
			{'x':8,'y':12,'flag':16544,'scriptPointer':2148807},
			{'x':8,'y':13,'flag':16544,'scriptPointer':2148819},
			{'x':8,'y':14,'flag':16544,'scriptPointer':2148831},
		],

},
partial_map=[
	[0, 0, 0, 0, 0, 0, 0, 0, 0, 0, 0, 0, 0, 0, 0, 0, 0, 0, 0, 0, 0, 0, 0, 0, ],
	[0, 0, 0, 0, 0, 0, 0, 0, 0, 0, 0, 0, 0, 0, 0, 0, 0, 0, 0, 0, 0, 0, 0, 0, ],
	[0, 0, 0, 0, 0, 0, 0, 0, 0, 0, 0, 0, 0, 0, 0, 0, 0, 0, 0, 0, 0, 0, 0, 0, ],
	[1, 1, 1, 1, 1, 1, 1, 1, 1, 1, 1, 1, 1, 1, 1, 1, 1, 1, 1, 1, 1, 1, 1, 1, ],
	[12, 12, 12, 1, 1, 1, 1, 1, 1, 1, 1, 1, 1, 1, 1, 1, 1, 1, 1, 1, 1, 1, 1, 1, ],
	[12, 12, 12, 1, 5, 5, 5, 5, 5, 5, 5, 5, 5, 5, 5, 5, 5, 5, 5, 5, 5, 5, 5, 5, ],
	[12, 12, 12, 1, 5, 5, 5, 5, 5, 5, 5, 5, 5, 5, 5, 5, 5, 5, 5, 5, 5, 5, 5, 5, ],
	[12, 12, 12, 1, 5, 5, 5, 5, 5, 5, 5, 5, 5, 5, 5, 5, 5, 5, 5, 5, 5, 5, 5, 5, ],
	[12, 12, 12, 1, 5, 5, 5, 5, 5, 5, 5, 5, 5, 5, 5, 5, 5, 5, 5, 5, 5, 5, 5, 5, ],
	[12, 12, 12, 1, 5, 5, 5, 5, 5, 5, 5, 5, 5, 5, 5, 5, 5, 5, 5, 5, 5, 5, 5, 5, ],
	[12, 12, 12, 1, 1, 1, 1, 12, 12, 1, 1, 1, 1, 1, 1, 1, 1, 1, 13, 13, 1, 1, 1, 1, ],
	[12, 12, 12, 12, 12, 12, 12, 12, 12, 12, 12, 12, 12, 12, 12, 12, 12, 1, 13, 13, 13, 13, 13, 13, ],
	[12, 12, 12, 12, 12, 12, 12, 12, 12, 12, 12, 12, 12, 12, 12, 12, 12, 1, 13, 13, 13, 13, 13, 13, ],
	[12, 12, 12, 12, 12, 12, 12, 12, 12, 12, 12, 12, 12, 12, 12, 12, 12, 1, 13, 13, 13, 13, 13, 13, ],
	[12, 12, 12, 12, 12, 12, 12, 12, 12, 12, 12, 0, 0, 12, 12, 12, 12, 1, 13, 13, 13, 13, 13, 13, ],
]
