Connections;up:ROUTE 110 (0.25);down:ROUTE 109 (0.24);right:ROUTE 134 (0.49);
Exits;SLATEPORT CITY (9.11);SLATEPORT CITY (9.13);SLATEPORT CITY (9.0);SLATEPORT CITY (9.2);SLATEPORT CITY (9.6);SLATEPORT CITY (9.7);SLATEPORT CITY (9.5);SLATEPORT CITY (9.7);SLATEPORT CITY (9.9);SLATEPORT CITY (9.9);SLATEPORT CITY (9.10);
1 1 1 1 1 1 1 1 1 1 1 1 1 1 1 12 12 12 12 12 1 1 1 1 1 1 1 1 1 1 1 1 1 1 1 1 4 4 4 4 
1 1 1 1 1 1 1 1 1 1 1 1 1 1 1 1 12 12 12 12 1 1 1 1 1 1 1 1 1 1 1 1 1 1 1 1 4 4 4 4 
1 1 1 1 1 1 1 1 1 1 1 1 1 1 1 1 12 12 12 12 12 1 1 1 1 1 1 1 1 1 1 1 1 1 1 1 4 4 4 4 
1 1 1 1 1 1 1 1 1 1 1 1 1 1 1 1 12 12 12 12 12 1 1 1 1 1 1 1 1 1 1 1 1 1 1 1 4 4 4 4 
4 1 1 1 1 1 1 1 1 1 1 1 1 1 1 1 12 12 12 12 12 1 1 1 1 1 1 1 1 1 1 1 1 1 1 1 4 4 4 4 
4 1 1 1 1 1 1 1 1 1 1 1 1 1 1 1 12 12 12 12 12 1 1 1 1 1 1 1 1 1 1 1 1 1 1 1 4 4 1 1 
4 1 1 1 1 1 1 1 1 1 1 1 1 1 12 1 12 12 12 12 12 1 12 1 1 1 1 1 1 1 1 1 1 1 1 1 1 1 1 1 
4 1 1 1 1 1 1 1 1 1 1 1 1 12 12 1 12 12 12 12 12 1 12 12 1 1 1 1 1 1 1 1 1 1 1 1 1 1 4 4 
4 1 1 1 1 1 1 1 1 1 1 1 1 1 1 1 12 12 12 12 12 1 1 1 1 1 1 1 1 1 1 1 1 1 1 1 4 4 4 4 
4 1 1 13 12 12 12 12 1 1 1 1 1 12 12 12 1 12 12 12 1 12 12 12 12 1 1 1 1 1 1 1 4 4 4 4 4 4 4 4 
4 4 1 13 12 12 12 13 1 1 1 1 1 13 12 12 12 12 12 12 12 12 12 12 12 1 1 1 1 1 1 1 4 4 4 4 4 4 4 4 
4 4 1 13 12 12 12 13 1 1 1 1 1 13 12 12 12 12 12 12 12 12 12 12 12 1 1 1 1 1 1 1 4 4 4 4 4 4 4 4 
4 4 1 13 12 12 12 13 1 1 1 1 1 13 12 12 12 12 12 12 12 12 12 12 1 1 1 1 0 1 1 1 12 4 4 4 4 4 4 4 
4 4 4 13 12 12 12 1 12 12 12 12 12 12 12 12 12 12 12 12 12 12 12 12 12 12 12 12 12 12 12 12 12 12 12 12 12 12 4 4 
4 4 4 1 12 12 12 12 12 12 12 12 12 12 12 12 12 12 12 12 12 12 12 12 12 12 12 12 12 12 12 12 12 12 12 12 12 12 4 4 
4 4 4 1 12 12 12 12 12 12 12 12 12 12 12 12 12 12 12 12 12 12 12 12 12 12 12 12 12 12 12 12 12 12 12 12 12 12 1 1 
4 4 4 1 12 12 12 12 12 12 12 12 12 12 12 12 12 12 12 12 12 12 12 12 12 12 12 12 12 12 12 12 13 13 13 13 13 13 1 1 
4 4 4 1 1 1 1 1 12 12 12 12 12 12 12 12 12 12 1 1 1 1 12 12 12 12 12 12 12 12 12 12 4 4 4 1 1 4 4 4 
4 4 12 1 1 1 1 1 12 12 12 12 12 12 12 12 12 12 1 1 1 1 13 12 12 4 4 4 4 4 4 4 4 1 1 1 1 4 4 4 
4 4 12 1 1 1 1 1 1 12 12 12 12 12 12 12 12 12 1 1 1 1 1 4 4 4 4 4 4 4 4 4 4 1 1 4 4 4 4 4 
4 4 12 1 12 12 12 12 12 12 12 12 12 12 12 12 12 12 12 12 12 12 1 4 4 4 4 4 4 4 4 4 4 4 1 1 4 4 4 4 
4 1 1 1 12 12 12 12 12 12 12 12 12 12 12 12 12 12 12 12 12 12 1 4 4 4 4 4 4 4 4 4 4 4 1 1 4 4 4 4 
4 1 12 12 12 12 12 12 12 12 12 12 12 12 12 12 1 12 12 12 12 12 1 4 4 4 1 1 1 1 1 1 1 1 1 1 4 4 4 4 
4 1 1 1 1 1 1 12 12 12 12 12 12 12 12 12 12 12 12 12 12 12 1 4 4 1 12 12 1 1 1 1 1 1 12 12 1 4 4 4 
4 1 1 1 1 1 1 12 12 12 12 12 1 1 1 1 12 12 12 12 12 12 1 4 4 1 12 12 1 1 1 1 1 1 12 12 13 4 4 4 
4 1 1 1 1 1 1 12 12 12 12 12 1 1 1 1 12 12 12 12 12 12 1 4 4 13 12 13 1 1 1 1 1 1 13 12 13 4 4 4 
4 1 1 1 0 1 1 12 1 12 12 12 1 1 1 1 12 12 12 12 12 12 1 1 1 12 1 13 1 1 0 0 1 1 13 12 13 4 4 4 
4 1 12 12 12 12 12 12 12 12 12 12 12 12 12 12 12 12 12 12 12 12 12 12 12 12 12 12 12 12 12 12 12 12 12 12 13 4 4 4 
4 1 12 12 12 12 12 12 12 12 12 12 12 12 12 12 12 12 12 12 12 12 12 12 12 12 12 12 12 12 12 12 12 12 12 12 13 4 4 4 
4 1 12 12 12 12 12 12 12 12 12 12 12 12 12 12 12 12 12 12 12 12 1 1 1 12 12 12 12 12 12 12 12 12 12 12 13 4 4 4 
4 1 12 12 12 12 12 12 12 12 12 12 12 12 12 12 12 12 12 12 12 12 1 4 4 1 1 1 1 1 1 1 13 13 13 13 13 4 4 4 
4 1 12 12 12 12 12 12 12 12 12 12 12 12 12 12 12 12 12 12 12 12 1 4 4 4 4 4 4 4 4 4 4 4 4 4 4 4 4 4 
4 1 1 1 1 1 1 1 1 12 12 12 1 1 1 12 12 12 12 12 12 12 1 4 4 4 4 4 4 4 4 4 4 4 4 4 4 4 4 4 
4 1 0 12 1 12 12 12 12 12 12 12 12 1 1 12 12 12 12 12 12 12 1 12 1 1 1 1 1 1 1 1 12 12 12 12 12 12 12 4 
4 1 12 12 1 1 1 12 12 12 12 12 1 12 1 12 12 12 12 12 12 12 1 1 1 1 1 1 1 1 1 1 12 1 12 12 12 1 12 4 
4 1 12 1 1 1 1 12 12 12 12 1 1 12 1 12 12 12 12 12 12 1 1 1 1 1 1 1 1 1 1 1 4 1 1 1 4 4 4 4 
4 1 12 1 1 1 1 1 12 12 1 1 1 12 1 12 12 12 12 12 12 1 1 1 1 1 1 1 1 1 1 1 4 1 1 1 4 4 4 4 
4 1 12 1 1 1 1 12 12 12 12 12 1 12 1 12 12 12 12 12 12 12 12 12 1 1 12 1 1 1 1 1 4 1 1 1 1 1 1 4 
4 1 12 12 1 1 12 12 12 12 1 1 1 12 1 12 12 12 12 12 12 12 12 1 1 1 0 1 1 1 1 1 1 1 1 1 1 1 1 4 
4 1 12 12 1 1 12 12 12 1 1 12 1 12 1 12 12 12 12 12 12 12 12 12 12 12 12 12 12 12 12 12 12 1 1 1 1 1 1 4 
4 1 12 12 12 12 12 12 12 12 12 12 12 12 1 12 12 12 12 12 12 12 12 12 12 12 12 12 12 12 12 12 12 12 12 12 12 12 13 4 
4 1 12 12 12 12 12 1 1 12 12 12 12 12 1 12 12 12 12 0 12 12 12 12 12 12 12 12 12 12 12 12 12 12 12 12 12 12 1 4 
4 1 12 12 12 12 12 1 12 12 12 12 12 12 1 12 12 12 12 0 1 1 1 1 1 1 1 1 1 1 12 12 12 13 13 13 13 13 13 4 
4 1 1 1 1 12 1 1 12 12 1 1 1 1 1 12 12 12 12 0 1 1 1 1 1 1 1 1 1 1 12 12 13 4 4 4 4 4 4 4 
4 1 12 1 12 12 12 12 12 12 12 12 1 1 1 12 12 12 12 0 1 1 1 1 1 1 1 1 1 1 12 12 13 4 1 1 1 4 4 1 
4 1 12 12 12 12 12 1 12 12 12 12 12 12 1 12 12 12 12 12 12 12 12 12 12 12 12 12 12 12 12 12 13 4 1 1 1 4 4 4 
4 1 12 12 12 12 12 1 1 12 12 12 12 12 1 12 12 12 12 12 12 12 12 12 12 12 12 12 12 12 12 12 13 4 1 1 1 4 4 4 
4 1 1 1 12 12 1 1 1 12 1 12 12 1 1 12 12 12 12 12 1 1 1 1 1 1 1 1 1 1 1 1 13 4 4 4 4 4 4 4 
4 1 1 12 12 12 12 12 12 12 12 12 12 1 1 12 12 12 12 12 1 4 4 4 4 4 4 4 4 4 4 4 4 4 4 1 1 1 4 4 
4 1 12 12 12 12 12 12 12 12 12 12 12 12 1 12 12 12 12 12 1 4 4 4 4 4 4 4 4 4 4 4 4 4 4 1 1 1 4 4 
4 1 12 12 12 12 12 12 1 12 12 12 12 12 1 12 12 12 12 12 1 4 4 4 4 4 4 4 1 1 1 1 1 1 1 1 1 1 4 4 
4 1 1 1 1 12 1 12 1 12 1 12 1 1 1 12 12 12 12 12 1 1 1 1 1 1 1 1 12 12 12 12 12 12 12 12 12 1 4 4 
4 1 12 1 12 12 12 12 12 12 12 12 12 12 12 12 12 12 12 12 12 12 12 12 12 12 12 12 12 12 12 12 12 12 12 12 12 1 4 4 
4 1 12 1 1 12 12 12 12 12 12 12 12 12 12 12 12 12 12 12 12 12 12 12 12 12 12 12 12 12 12 12 1 1 12 12 12 1 4 4 
4 1 12 12 12 12 1 1 1 1 1 1 1 12 12 12 12 12 12 12 1 1 1 1 1 1 1 1 1 12 12 12 1 1 12 12 12 1 4 4 
4 1 12 12 12 12 1 1 1 1 0 0 0 0 0 12 12 12 12 12 1 12 12 12 12 12 12 12 1 12 12 12 12 12 12 12 12 1 12 4 
4 1 1 1 1 1 1 1 1 1 12 12 12 12 12 12 12 12 12 12 1 12 12 12 12 12 12 12 1 1 1 1 12 12 1 1 1 1 12 4 
4 4 4 1 1 4 12 12 1 1 1 1 1 1 1 1 1 12 12 12 1 12 12 12 12 12 12 12 12 12 12 1 12 12 1 12 4 5 5 4 
4 1 1 1 1 4 4 4 12 12 12 12 12 12 12 12 1 12 12 12 1 12 12 12 12 12 12 12 12 12 12 1 12 12 1 12 4 5 5 4 
4 1 1 4 4 4 4 4 12 12 12 12 12 12 12 12 12 12 12 12 12 12 12 12 12 12 12 12 12 12 12 12 12 12 12 12 4 4 5 5 
