connections=[
		],
events={
	{
		exits:[SLATEPORT CITY (0.1),SLATEPORT CITY (0.1),		]},
	{
		NPCs:[
			{is_trainer:0,b1:8,b2:0,sprite:19},
			{is_trainer:0,b1:3,b2:0,sprite:6},
			{is_trainer:0,b1:7,b2:0,sprite:68},
			{is_trainer:0,b1:1,b2:0,sprite:26},
			{is_trainer:0,b1:8,b2:0,sprite:48},
			{is_trainer:0,b1:1,b2:0,sprite:208},
			{is_trainer:0,b1:1,b2:0,sprite:203},
			{is_trainer:0,b1:1,b2:0,sprite:210},
			{is_trainer:0,b1:9,b2:0,sprite:65},
		]},
	{
		signs:[
		]},
	{
		triggers:[
		]},

},
[
	[1, 1, 1, 1, 1, 1, 1, 1, 1, 1, 1, 1, 1, 1, ],
	[1, 1, 1, 1, 1, 1, 1, 1, 1, 1, 1, 1, 1, 1, ],
	[1, 1, 1, 1, 12, 12, 12, 12, 12, 12, 1, 1, 1, 1, ],
	[12, 12, 12, 12, 12, 12, 12, 12, 12, 12, 12, 12, 12, 12, ],
	[12, 12, 12, 12, 12, 12, 12, 12, 12, 12, 12, 12, 12, 12, ],
	[12, 12, 12, 0, 0, 16, 16, 16, 16, 0, 0, 12, 12, 12, ],
	[12, 12, 12, 16, 0, 1, 1, 1, 1, 0, 16, 12, 12, 12, ],
	[12, 12, 12, 16, 0, 1, 1, 1, 1, 0, 16, 12, 12, 12, ],
	[12, 12, 12, 0, 12, 12, 12, 12, 12, 12, 0, 12, 12, 12, ],
	[12, 12, 12, 12, 12, 12, 12, 12, 12, 12, 12, 12, 12, 12, ],
	[1, 12, 12, 12, 12, 12, 0, 0, 12, 12, 12, 12, 12, 1, ],
]
