Connections;
Exits;SOOTOPOLIS CITY (0.7);SOOTOPOLIS CITY (0.7);SOOTOPOLIS CITY (15.1);
1 1 1 1 1 1 1 1 1 1 1 1 1 1 1 1 1 
1 1 1 1 1 1 1 1 1 1 1 1 1 1 1 1 1 
1 1 1 12 1 1 0 0 0 0 0 1 1 12 1 1 1 
1 1 1 12 12 12 0 0 0 0 0 12 12 12 1 1 1 
1 1 1 1 1 1 1 1 0 1 1 1 1 1 1 1 0 
1 1 1 1 1 1 1 1 0 1 1 1 1 1 1 1 0 
1 1 1 0 0 1 0 0 12 0 0 0 0 0 1 1 0 
1 1 1 0 0 0 0 0 0 1 0 0 1 0 1 1 0 
1 1 1 0 1 0 0 1 0 0 0 0 0 0 1 1 0 
1 1 1 0 0 0 0 0 0 0 0 1 0 0 1 1 1 
1 1 1 1 1 1 1 1 0 1 1 1 1 1 1 1 1 
1 1 1 1 1 1 1 1 0 1 1 1 1 1 1 1 1 
1 1 1 1 1 0 0 0 0 0 0 0 1 1 1 1 1 
1 1 1 1 1 0 1 0 0 0 1 0 1 1 1 1 1 
1 0 0 1 1 0 0 0 0 0 0 0 1 1 0 0 1 
1 0 0 1 1 1 1 1 0 1 1 1 1 1 0 0 1 
1 0 0 0 0 1 1 1 0 1 1 1 0 0 0 0 0 
1 0 0 0 0 1 1 1 0 0 1 1 0 0 0 0 0 
1 1 1 1 1 1 1 0 0 0 1 1 1 1 1 1 1 
1 1 1 1 1 1 1 0 0 1 1 1 1 1 1 1 1 
1 1 1 1 1 1 1 1 12 1 1 1 1 1 1 1 1 
1 1 1 1 1 1 1 1 12 1 1 1 1 1 1 1 1 
1 1 1 1 1 12 12 12 12 12 12 0 1 1 1 1 1 
1 1 1 1 1 12 0 12 12 12 0 12 1 1 1 1 1 
1 1 1 1 1 12 1 0 12 12 1 0 1 1 1 1 1 
1 1 1 1 1 12 0 0 0 0 0 0 1 1 1 1 1 
