connections=[
		],
events={
	{
		exits:[SOOTOPOLIS CITY (0.7),SOOTOPOLIS CITY (0.7),		]},
	{
		NPCs:[
			{is_trainer:0,b1:10,b2:0,sprite:44},
			{is_trainer:0,b1:8,b2:0,sprite:204},
		]},
	{
		signs:[
		]},
	{
		triggers:[
		]},

},
[
	[1, 1, 1, 1, 1, 1, 1, 1, ],
	[1, 1, 1, 1, 1, 1, 1, 1, ],
	[12, 12, 12, 12, 12, 12, 12, 12, ],
	[12, 12, 12, 13, 13, 12, 12, 12, ],
	[12, 12, 12, 13, 13, 12, 12, 12, ],
	[12, 12, 12, 12, 12, 12, 12, 12, ],
	[12, 12, 12, 0, 0, 12, 12, 12, ],
]
