connections=[
		],
events={
	{
		exits:[SOOTOPOLIS CITY (0.7),SOOTOPOLIS CITY (0.7),SOOTOPOLIS CITY (15.14),		]},
	{
		NPCs:[
			{is_trainer:0,b1:10,b2:0,sprite:29},
		]},
	{
		signs:[
		]},
	{
		triggers:[
		]},

},
[
	[1, 1, 1, 1, 1, 1, 1, 1, 1, 1, 1, ],
	[1, 1, 1, 0, 1, 1, 1, 1, 1, 1, 1, ],
	[0, 0, 1, 1, 1, 0, 0, 0, 0, 0, 0, ],
	[0, 0, 0, 0, 0, 0, 0, 0, 0, 0, 0, ],
	[0, 0, 0, 0, 0, 0, 0, 1, 1, 0, 0, ],
	[0, 0, 0, 0, 0, 0, 0, 1, 1, 0, 0, ],
	[0, 0, 0, 0, 0, 0, 0, 0, 0, 0, 0, ],
	[0, 0, 0, 0, 0, 0, 0, 0, 0, 0, 0, ],
]
