Connections;
Exits;SOOTOPOLIS CITY (15.2);SOOTOPOLIS CITY (15.4);SOOTOPOLIS CITY (15.0);CAVE OF ORIGIN (24.37);SOOTOPOLIS CITY (15.5);SOOTOPOLIS CITY (15.6);SOOTOPOLIS CITY (15.7);SOOTOPOLIS CITY (15.8);SOOTOPOLIS CITY (15.9);SOOTOPOLIS CITY (15.10);SOOTOPOLIS CITY (15.11);SOOTOPOLIS CITY (15.12);SOOTOPOLIS CITY (15.13);
1 1 1 1 1 1 1 1 1 1 1 1 1 1 1 1 12 1 12 12 1 1 1 1 1 1 1 1 1 1 1 1 1 1 1 1 1 1 1 12 12 12 12 12 1 1 1 1 1 1 1 1 1 1 1 12 12 12 12 12 
1 1 1 1 1 1 1 1 1 1 1 1 1 1 1 1 1 1 12 12 1 1 1 1 1 1 1 1 1 1 1 1 1 1 1 1 1 1 1 1 1 1 1 1 1 1 1 1 1 1 1 1 1 1 1 1 1 1 1 12 
1 1 1 1 1 1 1 1 1 1 1 1 1 12 12 12 1 12 12 12 1 1 1 1 1 1 1 1 1 1 1 1 1 1 12 1 1 1 1 1 1 1 1 12 12 12 12 12 12 12 12 1 1 1 1 1 1 1 1 12 
1 1 1 1 1 1 1 1 1 1 1 1 1 1 1 1 1 12 12 12 1 1 1 1 1 12 12 1 1 1 1 1 1 1 12 12 1 1 12 12 12 12 1 1 1 1 1 12 12 12 12 1 1 1 1 1 1 1 1 1 
1 1 1 1 1 1 1 1 1 1 1 1 1 1 1 1 1 1 1 1 1 1 1 1 1 12 12 1 1 1 1 1 1 1 1 12 12 1 1 1 1 1 1 1 1 1 1 1 12 12 12 1 1 1 1 1 1 1 1 1 
1 1 1 1 1 1 1 12 1 1 1 1 1 1 1 12 12 12 12 12 12 1 1 1 1 12 12 12 12 12 12 12 12 12 1 1 1 12 1 1 1 12 12 12 1 1 1 1 1 12 12 12 12 12 1 1 1 12 12 1 
1 1 1 1 1 1 12 12 1 1 1 1 1 1 1 12 12 1 1 12 12 1 12 12 12 12 12 12 12 12 12 12 12 12 12 12 1 12 12 12 1 12 12 12 1 1 1 12 1 1 1 1 1 1 1 1 1 1 12 1 
1 1 1 1 1 1 1 1 1 12 1 1 1 1 12 12 12 1 12 12 12 12 12 12 12 12 1 1 1 12 12 1 1 1 1 1 1 1 12 12 1 1 1 1 1 12 1 1 1 1 1 1 1 1 1 1 1 1 12 12 
1 1 1 1 1 12 1 1 1 12 1 1 1 1 12 12 12 1 12 12 12 12 12 12 12 12 1 1 1 12 12 1 1 1 1 1 1 1 1 1 1 1 1 12 12 12 12 1 1 1 1 1 1 1 1 1 1 1 12 12 
1 1 1 1 1 12 1 12 1 12 1 1 1 1 12 12 12 1 1 1 1 1 1 1 1 1 1 12 12 12 12 12 12 12 12 12 1 1 1 1 1 1 1 1 1 12 1 1 1 1 1 1 1 1 1 1 1 1 1 1 
1 1 1 1 1 1 1 12 1 12 12 12 12 12 12 12 12 1 1 12 12 1 1 1 1 1 1 1 1 1 1 1 1 1 12 12 1 1 1 1 1 1 1 1 1 12 1 1 1 1 1 1 1 1 1 1 1 1 1 1 
1 1 1 1 1 1 1 1 1 1 1 1 1 1 1 12 12 1 1 1 1 1 1 1 1 1 1 1 1 1 1 1 1 1 12 12 1 1 1 1 12 1 1 1 1 12 12 12 12 12 12 1 1 1 1 1 12 12 1 12 
12 12 1 1 1 1 1 1 1 1 12 12 12 12 12 12 12 1 1 1 1 1 1 12 1 1 1 1 1 1 1 1 1 1 12 12 1 12 1 1 1 1 1 1 13 12 12 12 12 12 12 1 1 1 1 1 12 12 1 1 
1 1 1 12 1 1 1 1 1 12 12 1 1 1 1 12 12 1 12 1 1 1 1 1 1 12 12 12 12 12 12 12 12 12 12 12 1 1 1 1 1 1 1 1 1 1 1 1 12 12 12 1 1 12 12 1 1 1 12 12 
12 12 12 12 1 12 1 1 1 1 1 1 12 12 12 12 12 12 1 1 1 1 1 1 1 12 12 1 1 1 1 1 1 1 1 1 1 1 1 1 1 1 1 1 1 1 1 1 12 12 12 12 1 12 12 12 12 1 1 1 
12 1 1 1 1 12 1 1 1 1 1 1 12 12 12 12 12 12 1 12 1 1 12 1 1 12 12 1 1 1 1 1 1 1 1 1 12 12 1 1 1 1 1 1 1 1 1 1 12 12 12 12 1 12 12 12 12 12 12 1 
12 1 12 12 12 12 1 1 1 1 1 12 12 12 1 1 12 12 1 12 1 1 12 1 12 12 12 12 1 1 1 12 1 1 1 1 1 1 1 12 1 1 12 1 1 1 1 1 12 12 12 12 1 1 1 1 1 1 1 1 
1 1 12 12 12 12 1 1 1 1 1 12 12 12 1 1 12 12 1 1 1 1 12 1 12 12 12 12 1 1 12 12 12 1 1 12 12 12 1 1 1 1 12 1 1 1 1 1 1 12 12 12 12 1 1 1 1 1 1 1 
1 1 1 1 1 1 1 1 12 12 12 12 12 12 1 1 12 12 12 12 12 1 1 1 1 12 12 1 1 1 12 12 12 1 1 12 12 12 12 1 1 1 12 12 12 12 1 12 1 12 12 1 1 1 1 1 1 1 1 12 
1 1 1 1 1 1 1 1 12 12 12 12 12 12 1 1 12 12 12 12 12 1 1 1 1 12 12 1 1 12 13 12 13 12 1 1 1 12 12 1 1 1 12 12 12 12 1 1 1 12 12 1 1 1 1 1 1 1 1 12 
1 1 1 1 1 1 1 1 1 1 1 1 12 12 1 1 12 12 1 1 12 1 1 1 12 12 12 12 12 12 13 12 13 12 12 12 1 1 1 1 1 1 12 12 12 12 12 12 12 12 12 1 1 1 1 1 1 1 1 12 
1 1 1 1 1 1 1 12 1 1 1 1 12 12 1 1 12 12 1 1 12 1 1 1 12 12 12 12 12 12 12 12 12 12 12 12 12 12 1 1 1 1 1 1 12 12 12 12 12 12 12 1 12 12 12 1 1 1 1 1 
1 1 1 1 1 1 1 1 1 12 12 12 12 12 12 1 12 12 1 1 12 12 12 1 12 12 12 12 12 12 12 12 12 12 12 12 12 12 1 1 1 1 1 1 12 12 1 1 1 1 1 1 1 1 1 12 12 12 12 1 
1 1 1 1 1 12 1 1 1 1 1 1 12 12 1 1 1 1 1 1 12 12 12 1 12 12 1 1 1 1 1 1 1 1 1 1 1 1 1 1 1 1 1 1 12 12 12 1 1 1 1 12 12 12 1 1 12 12 12 12 
1 1 1 1 12 12 1 1 1 1 1 1 12 12 1 1 1 1 1 1 1 12 12 1 1 1 1 4 4 4 4 4 4 4 4 4 4 1 1 1 1 1 1 12 12 12 12 1 1 1 1 12 12 12 12 1 12 12 12 12 
12 1 1 1 12 12 1 1 1 1 1 12 12 12 1 1 1 1 12 12 1 12 12 1 1 4 4 4 4 4 4 4 4 4 4 4 4 1 1 1 1 1 1 12 12 12 12 1 1 1 1 12 1 1 1 1 1 12 12 12 
12 1 1 1 12 12 1 1 1 1 1 12 12 12 1 1 13 13 13 13 1 12 12 1 4 4 4 4 4 4 4 4 4 4 4 4 4 4 4 1 1 1 1 12 12 12 12 12 12 12 1 1 1 1 1 12 1 12 12 12 
12 1 1 1 12 12 1 1 12 12 12 12 12 12 1 1 1 1 1 1 1 12 12 1 4 4 4 4 4 4 4 4 4 4 4 4 4 4 4 1 1 1 1 1 1 1 12 12 12 12 12 1 1 1 1 12 1 1 12 12 
1 1 1 1 1 1 1 1 1 1 1 1 1 1 1 1 1 1 1 1 1 12 12 1 4 4 4 4 4 4 4 4 4 4 4 4 4 4 4 1 1 1 1 1 1 1 1 12 12 12 12 1 1 1 1 12 12 1 12 12 
12 12 1 1 1 1 1 1 1 1 1 1 1 1 1 1 1 1 1 1 1 12 12 1 4 4 4 4 1 1 1 1 1 1 4 4 4 4 4 1 1 1 1 1 1 1 1 12 12 12 12 1 1 12 1 12 12 1 1 12 
12 1 1 12 1 1 1 12 12 12 1 1 1 1 1 12 12 12 12 12 1 12 12 1 4 4 4 4 1 1 1 1 1 1 4 4 4 4 4 1 1 1 1 1 1 1 1 12 12 12 12 12 12 12 1 12 12 12 1 12 
12 1 12 12 1 12 12 12 12 12 1 12 12 12 12 12 12 12 12 1 1 12 12 1 4 4 4 4 1 1 1 1 1 1 4 4 4 4 4 1 1 1 1 1 1 1 1 1 12 12 1 12 12 12 1 1 1 1 1 1 
1 1 12 12 1 1 1 1 1 1 1 12 12 12 12 12 1 12 12 1 12 12 12 1 4 4 4 12 12 12 1 1 1 12 12 4 4 4 4 1 1 1 12 12 12 12 12 12 12 12 1 1 1 1 12 12 12 1 12 1 
1 12 12 1 1 1 1 1 1 1 1 12 12 12 12 1 1 12 12 12 12 12 12 1 4 4 4 12 12 12 12 12 12 12 12 4 4 4 4 1 1 1 12 12 12 12 12 12 12 12 12 12 12 1 1 1 1 1 12 1 
12 12 12 1 12 1 1 1 1 1 12 12 12 12 1 1 12 12 12 12 12 12 1 1 4 4 4 12 12 12 12 12 12 1 12 4 4 4 4 1 1 1 1 12 12 1 1 1 12 12 1 1 1 12 12 12 1 1 12 1 
12 1 1 1 1 1 1 1 1 1 12 12 12 12 1 12 1 1 1 12 12 1 1 4 4 4 4 12 12 12 12 12 12 12 12 4 4 4 4 1 1 1 1 12 12 1 1 1 12 12 1 1 1 1 1 1 1 1 12 1 
1 1 12 12 1 12 1 12 12 12 12 12 12 12 1 12 1 1 1 12 12 12 12 4 4 4 4 12 12 12 12 12 12 12 12 4 4 4 4 1 1 1 1 12 12 1 1 1 12 12 1 1 1 1 1 1 1 1 1 1 
1 1 1 1 1 12 1 1 12 12 12 12 1 1 1 12 1 1 1 12 12 12 12 4 4 4 4 4 4 4 4 4 4 4 4 4 4 4 4 4 12 13 12 12 12 1 1 1 12 12 12 12 12 1 1 1 1 12 1 1 
12 1 12 12 1 1 1 1 1 1 1 1 1 1 1 1 1 12 4 4 4 4 4 4 4 4 4 4 4 4 4 4 4 4 4 4 4 4 4 4 12 12 12 12 12 1 1 1 1 1 1 1 1 1 1 1 1 1 1 1 
1 1 12 1 1 1 1 1 1 1 1 1 1 1 12 12 12 12 4 4 4 4 4 4 4 4 4 4 4 4 4 4 4 4 4 4 4 4 4 4 12 12 12 12 12 1 1 1 1 1 1 1 1 1 1 1 1 1 1 1 
1 1 12 1 1 1 1 12 1 1 1 1 12 12 12 12 12 12 4 4 4 4 4 4 4 4 4 4 4 4 4 4 4 4 4 4 4 4 4 4 4 4 12 12 12 1 1 1 1 1 1 1 1 1 1 1 1 1 1 1 
1 1 12 1 1 1 1 12 1 1 1 1 12 12 12 12 12 12 4 4 4 4 4 4 4 4 4 4 4 4 4 4 4 4 4 4 4 4 4 4 4 4 12 12 12 12 12 12 12 12 1 1 1 1 1 1 1 1 1 1 
1 1 12 1 1 1 1 12 12 12 1 1 12 12 12 12 12 12 4 4 4 4 4 4 4 4 4 4 4 4 4 4 4 4 4 4 4 4 4 4 4 4 12 12 12 12 12 12 12 12 12 1 1 1 1 1 1 1 1 1 
1 1 12 1 1 1 1 12 12 12 1 1 12 12 12 12 12 12 4 4 4 4 4 4 4 4 4 4 4 4 4 4 4 4 4 4 4 4 4 4 4 4 4 4 4 12 12 12 12 12 12 1 1 1 1 1 1 1 1 1 
1 1 12 1 1 1 1 12 12 12 12 12 12 12 12 12 12 12 4 4 4 4 4 4 4 4 4 4 4 4 4 4 4 4 4 4 4 4 4 4 4 4 4 4 4 12 12 12 12 1 1 1 1 1 1 1 1 1 1 1 
1 1 12 1 1 1 1 12 12 12 12 12 12 12 1 1 12 12 4 4 4 4 4 4 4 4 4 4 4 4 4 4 4 4 4 4 4 4 4 4 4 4 4 4 4 12 12 12 12 1 1 1 1 1 1 1 1 1 1 1 
1 1 1 1 1 1 1 1 1 1 1 12 12 12 1 1 4 4 4 4 4 4 4 4 4 4 4 4 4 4 4 4 4 4 4 4 4 4 4 4 4 4 4 4 4 4 4 4 4 1 1 1 1 1 1 1 1 1 1 1 
1 1 1 1 1 1 1 1 1 1 1 1 1 12 1 1 4 4 4 4 4 4 4 4 4 4 4 4 4 4 4 4 4 4 4 4 4 4 4 4 4 4 4 4 4 4 4 4 4 1 1 1 1 1 1 1 1 1 1 1 
1 1 1 1 1 1 1 1 1 1 1 1 1 12 1 1 4 4 4 4 4 4 4 4 4 4 4 4 4 4 4 4 4 4 4 4 4 4 4 4 4 4 4 4 4 4 4 1 1 1 12 12 12 12 1 1 1 1 1 1 
1 1 1 1 1 1 1 1 1 1 1 1 1 1 1 1 4 4 4 4 4 4 4 4 4 4 4 4 4 4 4 4 4 4 4 4 4 4 4 4 4 4 4 4 4 4 4 1 1 1 1 1 1 1 1 1 1 1 1 1 
1 1 1 1 1 1 1 1 1 1 1 1 1 1 1 1 4 4 4 4 4 4 4 4 4 4 4 4 4 4 4 4 4 4 4 4 4 4 4 4 4 1 1 1 1 1 1 1 1 1 1 1 1 1 1 1 1 1 1 1 
1 1 1 1 1 1 1 1 1 1 1 1 1 1 1 1 4 4 4 4 4 4 4 4 4 4 4 4 4 4 4 4 4 4 4 4 4 4 4 4 4 1 1 1 1 1 1 1 1 1 1 1 1 1 1 1 1 1 1 1 
1 1 1 1 1 1 1 1 1 1 1 1 1 1 1 1 4 4 4 4 4 4 4 4 4 4 4 4 4 4 4 4 4 4 4 4 4 1 1 1 1 1 1 1 1 1 1 1 1 1 1 1 1 1 1 1 1 1 1 1 
1 1 1 1 1 1 1 1 1 1 1 1 1 1 1 1 4 4 4 4 4 4 4 4 4 4 4 4 4 4 4 4 4 4 4 4 4 5 1 1 1 1 1 1 1 1 1 1 1 1 1 1 1 1 1 1 1 1 1 1 
1 1 1 1 1 1 1 1 1 1 1 1 1 1 1 1 4 4 4 4 4 4 4 4 4 4 4 4 4 4 4 4 4 4 4 4 4 5 1 1 1 1 1 1 1 1 1 1 1 1 1 1 1 1 1 1 1 1 1 1 
1 1 1 1 1 1 1 1 1 1 1 1 1 1 1 1 1 1 1 1 4 4 4 4 4 4 4 4 4 4 4 4 4 4 4 1 1 1 1 1 1 1 1 1 1 1 1 1 1 1 1 1 1 1 1 1 1 1 1 1 
1 1 1 1 1 1 1 1 1 1 1 1 1 1 1 1 1 1 1 1 1 1 1 1 1 1 1 1 1 1 1 1 1 1 1 1 1 1 1 1 1 1 1 1 1 1 1 1 1 1 1 1 1 1 1 1 1 1 1 1 
1 1 1 1 1 1 1 1 1 1 1 1 1 1 1 1 1 1 1 1 1 1 1 1 1 1 1 1 1 1 1 1 1 1 1 1 1 1 1 1 1 1 1 1 1 1 1 1 1 1 1 1 1 1 1 1 1 1 1 1 
1 1 1 1 1 1 1 1 1 1 1 1 1 1 1 1 1 1 1 1 1 1 1 1 1 1 1 1 1 1 1 1 1 1 1 1 1 1 1 1 1 1 1 1 1 1 1 1 1 1 1 1 1 1 1 1 1 1 1 1 
1 1 1 1 1 1 1 1 1 1 1 1 1 1 1 1 1 1 1 1 1 1 1 1 1 1 1 1 1 1 1 1 1 1 1 1 1 1 1 1 1 1 1 1 1 1 1 1 1 1 1 1 1 1 1 1 1 1 1 1 
