connections=[
		],
events={
	{
		exits:[SOOTOPOLIS CITY (15.13),		]},
	{
		NPCs:[
			{is_trainer:0,b1:9,b2:0,sprite:240},
		]},
	{
		signs:[
		]},
	{
		triggers:[
		]},

},
[
	[1, 1, 1, 1, 1, 1, 1, 1, 1, 1, 1, 1, ],
	[1, 1, 1, 0, 1, 1, 1, 1, 1, 1, 1, 1, ],
	[1, 0, 0, 0, 0, 0, 0, 0, 0, 0, 0, 1, ],
	[0, 0, 0, 0, 0, 0, 0, 0, 0, 0, 0, 0, ],
	[0, 0, 0, 0, 0, 0, 0, 0, 0, 0, 0, 0, ],
	[0, 0, 0, 0, 0, 0, 0, 0, 0, 0, 0, 0, ],
	[0, 0, 0, 0, 0, 0, 0, 0, 0, 0, 0, 0, ],
	[0, 0, 0, 0, 0, 0, 0, 0, 0, 0, 0, 0, ],
	[1, 0, 0, 0, 0, 0, 0, 0, 0, 0, 0, 1, ],
]
