Connections;
Exits;SOOTOPOLIS CITY (0.7);SOOTOPOLIS CITY (0.7);
1 1 1 1 1 1 1 1 
1 1 1 1 1 1 1 1 
12 12 12 12 12 12 13 13 
12 12 12 13 13 12 12 12 
12 12 12 13 13 12 12 12 
12 12 12 12 12 12 12 12 
12 12 12 0 0 12 12 12 
