connections=[
		],
events={
	
		'exits':[{'name':'SOOTOPOLIS CITY (15.13)','x':3,'y':1},		],
	
		'NPCs':[
			{'is_trainer':0,'b1':9,'b2':0,'sprite':'240','x':6,'y':5},
		],
	
		'signs':[
		],
	
		'triggers':[
		],

},
partial_map=[
	[1, 1, 1, 1, 1, 1, 1, 1, 1, 1, 1, 1, ],
	[1, 1, 1, 0, 1, 1, 1, 1, 1, 1, 1, 1, ],
	[1, 0, 0, 0, 0, 0, 0, 0, 0, 0, 0, 1, ],
	[0, 0, 0, 0, 0, 0, 0, 0, 0, 0, 0, 0, ],
	[0, 0, 0, 0, 0, 0, 0, 0, 0, 0, 0, 0, ],
	[0, 0, 0, 0, 0, 0, 0, 0, 0, 0, 0, 0, ],
	[0, 0, 0, 0, 0, 0, 0, 0, 0, 0, 0, 0, ],
	[0, 0, 0, 0, 0, 0, 0, 0, 0, 0, 0, 0, ],
	[1, 0, 0, 0, 0, 0, 0, 0, 0, 0, 0, 1, ],
]
