Connections;
Exits;SOUTHERN ISLAND (26.10);SOUTHERN ISLAND (26.10);
1 1 1 13 13 1 13 13 13 13 13 13 13 13 13 13 13 13 13 13 13 13 13 13 13 13 13 12 1 1 1 5 4 
1 1 1 13 13 13 13 13 13 13 13 13 13 13 13 13 13 13 13 13 13 13 13 13 13 13 13 1 1 1 1 5 4 
1 1 1 13 13 13 13 13 13 13 13 13 13 13 13 13 13 13 13 13 13 13 13 13 13 13 13 1 1 1 1 5 4 
1 1 1 13 13 13 13 13 13 13 13 13 13 13 13 13 13 13 13 13 13 13 13 13 13 13 13 1 1 1 1 5 4 
1 1 1 13 13 13 13 13 13 13 13 13 13 13 13 13 13 13 13 13 13 13 13 13 13 13 13 1 1 1 1 5 4 
1 1 1 13 13 13 13 13 13 13 13 13 13 13 12 12 13 13 13 13 13 13 13 13 13 13 13 1 1 1 1 5 4 
1 1 1 12 13 13 13 13 13 13 13 13 13 13 12 12 13 13 13 13 13 13 13 13 13 13 1 1 1 1 1 5 4 
1 1 1 1 1 13 13 13 13 13 13 13 13 12 12 12 13 13 13 13 13 13 13 13 13 13 1 1 1 1 1 5 4 
1 1 1 1 1 13 13 13 13 13 13 13 13 12 12 12 12 13 13 12 12 12 12 12 12 13 1 1 1 1 5 4 4 
1 1 1 1 1 13 13 13 13 13 13 13 13 12 12 12 12 12 12 12 13 13 13 12 12 12 1 1 1 1 5 4 4 
1 1 1 1 1 12 13 13 13 13 13 13 13 13 12 12 12 12 12 13 13 13 13 13 12 12 1 1 1 1 5 4 4 
5 1 1 1 1 13 13 1 13 13 13 13 13 13 13 12 12 12 13 13 13 13 13 1 12 12 1 1 1 1 5 4 4 
5 1 1 1 1 13 13 1 12 13 13 13 13 13 13 13 13 13 1 13 13 13 13 1 12 12 12 1 1 1 5 4 4 
4 5 1 1 1 1 1 1 1 1 1 13 13 13 13 13 13 1 1 13 13 13 13 1 12 12 1 1 1 1 5 4 4 
4 5 1 1 1 1 1 13 13 1 1 13 13 13 1 1 1 1 1 1 1 1 1 1 12 12 12 12 5 1 5 4 4 
4 5 1 1 1 1 1 13 13 1 1 13 13 13 1 1 1 1 1 12 12 12 12 12 12 12 1 1 5 5 4 4 4 
4 5 1 1 1 1 1 1 1 1 1 1 1 1 1 12 12 12 12 12 12 12 12 12 12 1 1 1 1 5 4 4 4 
4 5 1 1 1 1 1 1 1 1 12 12 12 12 12 12 12 12 12 12 1 1 1 1 1 1 1 1 5 4 4 4 4 
4 4 4 4 5 1 1 1 1 1 1 1 1 1 1 12 12 1 1 1 1 1 5 5 5 5 5 4 4 4 4 4 4 
4 4 4 4 4 4 4 5 1 1 1 1 1 1 1 12 12 1 1 1 5 5 4 4 4 4 4 4 4 4 4 4 4 
4 4 4 4 4 4 4 4 4 4 5 5 5 5 1 12 12 1 4 4 4 4 4 4 4 4 4 4 4 4 4 4 4 
4 4 4 4 4 4 4 4 4 4 1 12 12 12 12 12 12 1 4 4 4 4 4 4 4 4 4 4 4 4 4 4 4 
4 4 4 4 4 4 4 4 4 4 1 12 12 12 12 12 12 1 4 4 4 4 4 4 4 4 4 4 4 4 4 4 4 
4 4 4 4 4 4 4 4 4 4 1 1 1 12 12 1 1 1 4 4 4 4 4 4 4 4 4 4 4 4 4 4 4 
4 4 4 4 4 4 4 4 4 4 1 1 1 1 1 1 1 1 4 4 4 4 4 4 4 4 4 4 4 4 4 4 4 
4 4 4 4 4 4 4 4 4 4 4 4 4 4 4 4 4 4 4 4 4 4 4 4 4 4 4 4 4 4 4 4 4 
4 4 4 4 4 4 4 4 4 4 4 4 4 4 4 4 4 4 4 4 4 4 4 4 4 4 4 4 4 4 4 4 4 
4 4 4 4 4 4 4 4 4 4 4 4 4 4 4 4 4 4 4 4 4 4 4 4 4 4 4 4 4 4 4 4 4 
4 4 4 4 4 4 4 4 4 4 4 4 4 4 4 4 4 4 4 4 4 4 4 4 4 4 4 4 4 4 4 4 4 
4 4 4 4 4 4 4 4 4 4 4 4 4 4 4 4 4 4 4 4 4 4 4 4 4 4 4 4 4 4 4 4 4 
