Connections;
Exits;TERRA CAVE (24.105);
1 1 1 1 1 1 1 1 1 1 1 1 1 1 1 1 1 1 1 1 
1 1 1 1 1 1 1 1 1 1 1 1 1 1 12 1 1 1 1 1 
1 1 1 1 1 1 1 1 1 1 1 1 1 12 12 12 1 1 1 1 
1 1 1 1 1 1 1 1 1 1 12 12 12 12 12 12 1 1 1 1 
1 1 1 1 1 1 1 1 1 1 12 12 1 1 1 12 1 1 1 1 
1 1 1 1 1 1 1 1 12 12 12 12 1 1 1 12 1 1 1 1 
1 1 1 1 1 1 1 1 12 12 12 12 1 1 1 12 1 1 1 1 
1 1 1 1 1 1 12 12 12 12 12 12 1 1 1 12 1 1 1 1 
1 1 1 1 1 1 12 12 1 1 1 1 1 1 1 12 1 1 1 1 
1 1 1 1 1 12 12 1 1 1 1 1 1 1 1 12 1 1 1 1 
1 1 1 1 1 12 12 1 1 1 1 12 12 12 12 12 1 1 1 1 
1 1 1 12 12 12 12 1 1 1 1 12 12 12 12 12 1 1 1 1 
1 1 1 12 12 12 12 1 1 1 12 12 12 12 12 12 1 1 1 1 
1 1 1 12 12 12 12 1 1 12 12 12 12 1 1 12 1 1 1 1 
1 1 1 12 12 12 12 12 12 12 12 12 12 1 1 12 12 12 1 1 
1 1 1 12 12 12 12 12 12 12 12 12 12 1 1 12 12 12 1 1 
1 1 1 1 12 12 12 12 12 12 12 12 12 12 12 12 12 1 1 1 
1 1 1 1 1 12 12 12 12 12 12 12 1 1 1 1 1 1 1 1 
1 1 1 1 1 1 1 12 0 12 12 1 1 1 1 1 1 1 1 1 
1 1 1 1 1 1 1 1 1 1 1 1 1 1 1 1 1 1 1 1 
