Connections;
Exits;TERRA CAVE (24.104);
1 1 1 1 1 1 1 1 1 1 1 1 1 1 1 1 1 1 1 1 1 1 1 1 1 1 1 
1 1 1 1 1 1 1 1 1 1 1 1 1 1 1 1 1 1 1 1 1 1 1 1 1 1 1 
1 1 1 1 1 1 1 1 1 1 12 12 12 1 1 1 1 1 1 1 1 1 1 1 1 1 1 
1 1 1 1 1 1 1 1 1 1 12 12 12 1 1 1 1 1 1 1 1 1 1 1 1 1 1 
1 1 1 1 12 12 12 12 12 12 12 12 12 12 12 12 1 1 1 1 1 1 1 1 1 1 1 
1 1 1 1 1 1 1 1 1 12 12 12 12 12 12 12 1 1 1 1 1 1 1 1 1 1 1 
1 1 1 1 1 1 1 1 1 12 12 12 12 12 12 12 1 1 1 1 1 1 1 1 1 1 1 
1 1 1 1 1 1 1 1 1 12 12 12 12 12 12 12 1 1 1 1 1 1 1 1 1 1 1 
1 1 1 1 1 1 1 1 1 12 12 12 12 12 12 12 1 1 1 1 1 1 1 1 1 1 1 
1 1 1 1 1 1 1 1 1 0 1 1 1 1 1 1 1 1 1 1 1 1 1 1 1 1 1 
1 1 1 1 1 1 1 1 1 12 12 12 12 12 12 1 1 1 1 1 1 1 1 1 1 1 1 
1 1 1 1 1 1 1 1 12 12 12 12 12 12 12 12 12 12 1 1 1 1 1 1 1 1 1 
1 1 1 1 1 1 1 12 12 12 12 12 12 12 12 1 1 1 1 1 1 1 1 1 1 1 1 
1 1 1 1 1 1 1 12 12 12 12 12 12 1 1 1 1 1 1 1 1 1 1 1 1 1 1 
1 1 1 1 1 1 12 12 12 12 12 1 1 1 1 1 1 1 1 1 1 1 1 1 1 1 1 
1 1 1 1 1 1 12 12 12 12 12 1 1 1 1 1 1 1 1 1 1 1 1 1 1 1 1 
1 1 1 1 1 12 12 12 12 1 1 1 1 1 1 1 1 1 1 1 1 1 1 1 1 1 1 
1 1 1 1 1 12 12 12 12 1 1 1 1 1 1 1 5 5 5 1 1 1 1 1 1 1 1 
1 1 1 1 1 12 12 12 1 1 1 1 1 1 1 5 5 5 5 5 5 1 1 1 1 1 1 
1 1 1 1 1 12 12 12 1 1 1 1 1 5 5 5 5 5 5 5 5 5 5 1 1 1 1 
1 1 1 1 1 12 12 12 1 1 1 1 1 5 5 5 5 5 5 5 5 5 5 1 1 1 1 
1 1 1 1 1 12 12 12 1 1 1 1 1 5 5 5 5 5 5 5 5 5 5 1 1 1 1 
1 1 1 1 12 12 12 12 1 1 1 1 5 5 5 5 5 5 5 5 5 5 5 1 1 1 1 
1 1 1 1 12 12 12 12 1 1 1 1 5 5 5 5 5 5 5 5 5 5 5 1 1 1 1 
1 1 1 1 12 12 12 12 1 1 1 12 12 1 5 5 5 5 5 5 5 5 5 1 1 1 1 
1 1 1 1 12 12 12 12 1 1 1 12 12 12 1 5 5 5 5 5 1 12 12 12 1 1 1 
1 1 1 1 12 12 12 12 12 12 12 12 12 12 12 12 12 12 12 12 12 1 1 1 1 1 1 
1 1 1 1 1 1 1 1 1 1 1 12 12 12 12 12 12 12 12 12 12 1 1 1 1 1 1 
1 1 1 1 1 1 1 1 1 1 1 1 1 1 1 1 1 1 1 1 1 1 1 1 1 1 1 
1 1 1 1 1 1 1 1 1 1 1 1 1 1 1 1 1 1 1 1 1 1 1 1 1 1 1 
