Connections;
Exits;TRAINER HILL (26.60);TRAINER HILL (26.62);
1 1 1 1 1 1 1 1 1 1 1 1 1 1 1 1 
1 1 12 1 1 1 1 1 1 1 1 1 12 1 1 1 
12 12 12 12 1 1 1 1 1 1 1 12 12 12 12 1 
12 12 12 12 1 1 1 1 1 1 1 12 12 12 12 1 
12 12 12 12 1 1 1 1 1 1 1 12 12 12 12 1 
12 12 12 12 12 12 1 1 1 12 12 12 12 12 12 1 
12 12 12 12 12 12 12 12 12 12 12 12 12 12 12 1 
12 12 12 12 12 12 12 12 12 12 12 12 12 12 12 1 
12 12 12 12 12 12 12 12 12 12 12 12 12 12 12 1 
12 12 12 12 12 12 12 12 12 12 12 12 12 12 12 1 
12 12 12 12 12 12 12 12 12 12 12 12 12 12 12 1 
12 12 12 12 12 12 12 12 12 12 12 12 12 12 12 1 
12 12 12 12 12 12 12 12 12 12 12 12 12 12 12 1 
12 12 12 12 12 12 12 12 12 12 12 12 12 12 12 1 
12 12 12 12 12 12 12 12 12 12 12 12 12 12 12 1 
12 12 12 12 12 12 12 12 12 12 12 12 12 12 12 1 
12 12 12 12 12 12 12 12 12 12 12 12 12 12 12 1 
12 12 12 12 12 12 12 12 12 12 12 12 12 12 12 1 
12 12 12 12 12 12 12 12 12 12 12 12 12 12 12 1 
12 12 12 12 12 12 12 12 12 12 12 12 12 12 12 1 
12 12 12 12 12 12 12 12 12 12 12 12 12 12 12 1 
