Connections;
Exits;UNDERWATER (0.53);
1 1 1 1 1 1 1 1 1 1 1 1 1 1 
1 1 1 1 1 1 1 1 1 1 1 1 1 1 
1 1 1 1 1 1 1 1 1 1 1 1 1 1 
1 1 1 1 1 1 1 1 1 1 1 1 1 1 
1 1 1 1 1 13 13 13 13 1 1 1 1 1 
1 1 1 1 12 12 12 12 12 12 1 1 1 1 
1 1 1 12 12 12 12 12 12 12 1 1 1 1 
1 1 1 1 12 12 0 12 12 12 1 1 1 1 
1 1 1 1 1 1 1 1 1 1 1 1 1 1 
