Connections;
Exits;UNDERWATER (0.51);UNDERWATER (0.51);
1 1 1 1 1 1 1 1 1 1 1 1 1 1 1 1 1 1 1 1 
1 1 1 1 1 1 1 1 1 1 1 1 1 1 1 1 1 1 1 1 
1 1 1 1 1 1 1 1 1 1 1 1 1 1 1 1 1 1 1 1 
1 1 1 1 1 1 1 1 1 1 1 1 1 1 1 1 1 1 1 1 
1 1 1 1 1 1 1 1 1 1 1 1 1 1 1 1 1 1 1 1 
1 1 1 1 1 1 1 12 12 12 12 12 1 1 1 1 1 1 1 1 
1 1 1 1 1 12 12 12 12 12 12 12 12 12 1 1 1 1 1 1 
1 1 1 1 1 12 12 12 12 12 12 12 12 12 12 1 1 1 1 1 
1 1 1 1 1 1 12 12 12 0 12 12 12 12 12 1 1 1 1 1 
1 1 1 1 1 1 1 1 1 1 1 1 1 1 1 1 1 1 1 1 
