connections=[
		],
events={
	
		'exits':[{'name':'UNDERWATER (0.53)','x':6,'y':7},		],
	
		'NPCs':[
			{'is_trainer':0,'b1':76,'b2':0,'sprite':'100','x':5,'y':4},
			{'is_trainer':0,'b1':76,'b2':0,'sprite':'100','x':6,'y':4},
			{'is_trainer':0,'b1':76,'b2':0,'sprite':'100','x':7,'y':4},
			{'is_trainer':0,'b1':76,'b2':0,'sprite':'100','x':8,'y':4},
		],
	
		'signs':[
		],
	
		'triggers':[
		],

},
partial_map=[
	[1, 1, 1, 1, 1, 1, 1, 1, 1, 1, 1, 1, 1, 1, ],
	[1, 1, 1, 1, 1, 1, 1, 1, 1, 1, 1, 1, 1, 1, ],
	[1, 1, 1, 1, 1, 1, 1, 1, 1, 1, 1, 1, 1, 1, ],
	[1, 1, 1, 1, 1, 1, 1, 1, 1, 1, 1, 1, 1, 1, ],
	[1, 1, 1, 1, 1, 13, 13, 13, 13, 1, 1, 1, 1, 1, ],
	[1, 1, 1, 1, 12, 12, 12, 12, 12, 12, 1, 1, 1, 1, ],
	[1, 1, 1, 12, 12, 12, 12, 12, 12, 12, 1, 1, 1, 1, ],
	[1, 1, 1, 1, 12, 12, 0, 12, 12, 12, 1, 1, 1, 1, ],
	[1, 1, 1, 1, 1, 1, 1, 1, 1, 1, 1, 1, 1, 1, ],
]
