connections=[
		],
events={
	
		'exits':[{'name':'VERDANTURF TOWN (0.14)','x':7,'y':7},{'name':'VERDANTURF TOWN (0.14)','x':8,'y':7},		],
	
		'NPCs':[
			{'is_trainer':0,'b1':2,'b2':0,'sprite':'135','x':14,'y':5},
			{'is_trainer':0,'b1':8,'b2':0,'sprite':'44','x':5,'y':4},
			{'is_trainer':0,'b1':8,'b2':0,'sprite':'25','x':7,'y':2},
			{'is_trainer':0,'b1':10,'b2':0,'sprite':'18','x':2,'y':4},
			{'is_trainer':0,'b1':9,'b2':0,'sprite':'20','x':5,'y':5},
		],
	
		'signs':[
		],
	
		'triggers':[
		],

},
partial_map=[
	[1, 1, 1, 1, 1, 1, 1, 1, 1, 1, 1, 1, 1, 1, 1, 1, 1, ],
	[1, 1, 1, 1, 1, 1, 1, 1, 1, 1, 1, 1, 1, 1, 1, 1, 1, ],
	[12, 12, 12, 12, 12, 12, 12, 12, 12, 12, 12, 12, 1, 12, 0, 12, 0, ],
	[12, 12, 12, 12, 12, 12, 12, 12, 12, 12, 12, 12, 1, 0, 16, 1, 16, ],
	[12, 12, 12, 1, 1, 12, 12, 12, 12, 12, 12, 12, 1, 12, 0, 12, 0, ],
	[12, 12, 12, 1, 1, 12, 12, 12, 12, 12, 12, 12, 1, 12, 12, 12, 12, ],
	[12, 12, 12, 12, 12, 12, 12, 12, 12, 12, 12, 12, 12, 12, 12, 12, 12, ],
	[1, 12, 12, 12, 12, 12, 12, 0, 0, 12, 12, 12, 12, 12, 12, 12, 1, ],
]
