Connections;up:ROUTE 116 (0.31);right:ROUTE 117 (0.32);
Exits;VERDANTURF TOWN (6.0);VERDANTURF TOWN (6.3);VERDANTURF TOWN (6.4);VERDANTURF TOWN (6.6);RUSTURF TUNNEL (24.4);VERDANTURF TOWN (6.7);VERDANTURF TOWN (6.8);
1 1 1 1 1 1 1 1 1 1 1 1 1 1 1 1 1 1 1 1 
1 1 1 1 1 1 1 1 0 1 1 1 1 1 1 1 1 1 1 1 
1 1 1 1 1 1 1 12 12 12 13 1 1 1 1 1 1 1 1 12 
1 1 1 1 1 1 1 1 12 12 13 1 1 1 1 1 1 1 1 1 
1 1 1 1 1 1 12 12 12 12 13 12 12 12 12 12 12 12 12 1 
1 1 1 1 1 1 12 12 12 12 12 12 12 12 12 12 12 12 12 12 
1 1 1 1 1 1 12 12 12 12 12 12 12 12 1 12 12 12 12 12 
1 1 1 1 1 1 12 12 12 12 12 12 12 12 12 12 12 12 12 12 
1 1 12 12 12 12 12 12 12 12 12 12 12 12 12 12 12 12 12 12 
12 12 12 12 12 12 12 12 12 12 12 12 12 12 12 12 12 12 12 12 
12 12 12 12 12 12 12 12 12 12 12 12 12 12 12 12 12 12 12 12 
12 12 12 12 12 12 12 12 12 12 12 12 12 12 12 12 12 12 12 12 
1 1 1 1 1 1 1 1 1 1 1 1 1 12 12 12 12 12 12 12 
1 1 1 1 12 12 12 12 1 1 1 1 1 12 12 12 1 1 1 1 
1 1 1 1 12 12 12 1 1 1 1 1 1 12 12 12 1 1 1 1 
1 12 12 12 12 12 12 12 12 12 12 12 12 12 12 12 1 1 1 1 
1 12 12 12 12 12 12 12 12 12 12 12 12 12 12 12 12 12 12 12 
12 12 12 12 12 12 12 12 12 12 12 12 12 12 12 12 12 12 12 12 
1 12 12 12 12 12 12 1 1 1 1 12 12 12 12 1 1 1 12 1 
1 1 1 12 12 12 1 1 1 1 1 1 1 12 12 12 12 12 1 1 
