connections=[
			{'up':'ROUTE 116 (0.31)'},
			{'right':'ROUTE 117 (0.32)'},
		],
events={
	
		'exits':[{'name':'VERDANTURF TOWN (6.0)','x':3,'y':7},{'name':'VERDANTURF TOWN (6.3)','x':12,'y':3},{'name':'VERDANTURF TOWN (6.4)','x':16,'y':3},{'name':'VERDANTURF TOWN (6.6)','x':10,'y':14},{'name':'RUSTURF TUNNEL (24.4)','x':8,'y':1},{'name':'VERDANTURF TOWN (6.7)','x':1,'y':14},{'name':'VERDANTURF TOWN (6.8)','x':17,'y':15},		],
	
		'NPCs':[
			{'is_trainer':0,'b1':5,'b2':0,'sprite':'23','x':4,'y':17},
			{'is_trainer':0,'b1':9,'b2':0,'sprite':'6','x':9,'y':2},
			{'is_trainer':0,'b1':3,'b2':0,'sprite':'7','x':7,'y':11},
			{'is_trainer':0,'b1':5,'b2':0,'sprite':'31','x':7,'y':6},
		],
	
		'signs':[
			{'x':14,'y':3},
			{'x':14,'y':6},
			{'x':17,'y':3},
			{'x':7,'y':14},
			{'x':13,'y':3},
			{'x':18,'y':3},
			{'x':1,'y':8},
			{'x':7,'y':3},
		],
	
		'triggers':[
		],

},
partial_map=[
	[1, 1, 1, 1, 1, 1, 1, 1, 1, 1, 1, 1, 1, 1, 1, 1, 1, 1, 1, 1, ],
	[1, 1, 1, 1, 1, 1, 1, 1, 0, 1, 1, 1, 1, 1, 1, 1, 1, 1, 1, 1, ],
	[1, 1, 1, 1, 1, 1, 1, 12, 12, 12, 13, 1, 1, 1, 1, 1, 1, 1, 1, 12, ],
	[1, 1, 1, 1, 1, 1, 1, 1, 12, 12, 13, 1, 1, 1, 1, 1, 1, 1, 1, 1, ],
	[1, 1, 1, 1, 1, 1, 12, 12, 12, 12, 13, 12, 12, 12, 12, 12, 12, 12, 12, 1, ],
	[1, 1, 1, 1, 1, 1, 12, 12, 12, 12, 12, 12, 12, 12, 12, 12, 12, 12, 12, 12, ],
	[1, 1, 1, 1, 1, 1, 12, 12, 12, 12, 12, 12, 12, 12, 1, 12, 12, 12, 12, 12, ],
	[1, 1, 1, 1, 1, 1, 12, 12, 12, 12, 12, 12, 12, 12, 12, 12, 12, 12, 12, 12, ],
	[1, 1, 12, 12, 12, 12, 12, 12, 12, 12, 12, 12, 12, 12, 12, 12, 12, 12, 12, 12, ],
	[12, 12, 12, 12, 12, 12, 12, 12, 12, 12, 12, 12, 12, 12, 12, 12, 12, 12, 12, 12, ],
	[12, 12, 12, 12, 12, 12, 12, 12, 12, 12, 12, 12, 12, 12, 12, 12, 12, 12, 12, 12, ],
	[12, 12, 12, 12, 12, 12, 12, 12, 12, 12, 12, 12, 12, 12, 12, 12, 12, 12, 12, 12, ],
	[1, 1, 1, 1, 1, 1, 1, 1, 1, 1, 1, 1, 1, 12, 12, 12, 12, 12, 12, 12, ],
	[1, 1, 1, 1, 12, 12, 12, 12, 1, 1, 1, 1, 1, 12, 12, 12, 1, 1, 1, 1, ],
	[1, 1, 1, 1, 12, 12, 12, 1, 1, 1, 1, 1, 1, 12, 12, 12, 1, 1, 1, 1, ],
	[1, 12, 12, 12, 12, 12, 12, 12, 12, 12, 12, 12, 12, 12, 12, 12, 1, 1, 1, 1, ],
	[1, 12, 12, 12, 12, 12, 12, 12, 12, 12, 12, 12, 12, 12, 12, 12, 12, 12, 12, 12, ],
	[12, 12, 12, 12, 12, 12, 12, 12, 12, 12, 12, 12, 12, 12, 12, 12, 12, 12, 12, 12, ],
	[1, 12, 12, 12, 12, 12, 12, 1, 1, 1, 1, 12, 12, 12, 12, 1, 1, 1, 12, 1, ],
	[1, 1, 1, 12, 12, 12, 1, 1, 1, 1, 1, 1, 1, 12, 12, 12, 12, 12, 1, 1, ],
]
