connections=[
		],
events={
	{
		exits:[VERDANTURF TOWN (0.14),VERDANTURF TOWN (0.14),		]},
	{
		NPCs:[
			{is_trainer:0,b1:2,b2:0,sprite:135},
			{is_trainer:0,b1:8,b2:0,sprite:44},
			{is_trainer:0,b1:8,b2:0,sprite:25},
			{is_trainer:0,b1:10,b2:0,sprite:18},
			{is_trainer:0,b1:9,b2:0,sprite:20},
		]},
	{
		signs:[
		]},
	{
		triggers:[
		]},

},
[
	[1, 1, 1, 1, 1, 1, 1, 1, 1, 1, 1, 1, 1, 1, 1, 1, 1, ],
	[1, 1, 1, 1, 1, 1, 1, 1, 1, 1, 1, 1, 1, 1, 1, 1, 1, ],
	[12, 12, 12, 12, 12, 12, 12, 12, 12, 12, 12, 12, 1, 12, 0, 12, 0, ],
	[12, 12, 12, 12, 12, 12, 12, 12, 12, 12, 12, 12, 1, 0, 16, 1, 16, ],
	[12, 12, 12, 1, 1, 12, 12, 12, 12, 12, 12, 12, 1, 12, 0, 12, 0, ],
	[12, 12, 12, 1, 1, 12, 12, 12, 12, 12, 12, 12, 1, 12, 12, 12, 12, ],
	[12, 12, 12, 12, 12, 12, 12, 12, 12, 12, 12, 12, 12, 12, 12, 12, 12, ],
	[1, 12, 12, 12, 12, 12, 12, 0, 0, 12, 12, 12, 12, 12, 12, 12, 1, ],
]
