Connections;
Exits;VERDANTURF TOWN (0.14);VERDANTURF TOWN (0.14);
1 1 1 1 1 1 1 1 1 1 1 1 1 1 1 1 1 
1 1 1 1 1 1 1 1 1 1 1 1 1 1 1 1 1 
12 12 12 12 12 12 12 12 12 12 12 12 1 12 0 12 0 
12 12 12 12 12 12 12 12 12 12 12 12 1 0 16 1 16 
12 12 12 1 1 12 12 12 12 12 12 12 1 12 0 12 0 
12 12 12 1 1 12 12 12 12 12 12 12 1 12 12 12 12 
12 12 12 12 12 12 12 12 12 12 12 12 12 12 12 12 12 
1 12 12 12 12 12 12 0 0 12 12 12 12 12 12 12 1 
