Connections;
Exits;VICTORY ROAD (24.45);VICTORY ROAD (24.45);VICTORY ROAD (24.43);VICTORY ROAD (24.45);VICTORY ROAD (24.43);VICTORY ROAD (24.43);VICTORY ROAD (24.45);
1 1 1 1 1 1 1 1 1 1 1 1 1 1 1 1 1 1 1 1 1 1 1 1 1 1 1 1 1 1 1 1 1 1 1 1 1 1 1 1 1 1 1 1 1 16 
1 1 1 1 1 1 1 1 1 1 1 1 1 1 1 1 1 1 1 1 1 1 1 1 1 1 1 1 1 1 1 1 1 1 1 1 1 1 1 1 1 16 16 16 1 16 
1 1 1 1 1 1 1 1 1 1 1 1 1 1 1 1 1 1 1 1 1 1 1 1 1 1 1 1 1 1 1 1 1 1 1 1 1 1 1 1 1 16 16 16 1 16 
1 1 1 1 1 1 1 12 12 12 1 1 1 1 1 1 1 1 1 1 1 12 1 1 1 1 1 1 1 1 1 1 12 12 12 1 1 1 1 1 1 16 16 16 1 16 
1 1 1 1 12 12 12 12 12 12 12 1 12 1 1 1 1 1 1 12 12 12 12 12 12 12 1 1 1 1 1 1 1 12 12 12 1 1 1 1 1 16 16 16 1 16 
1 1 1 1 12 1 1 1 1 12 12 1 12 12 12 12 12 12 12 12 12 12 1 1 1 12 12 12 1 1 1 1 1 1 12 12 12 1 1 1 1 16 16 16 1 16 
1 1 1 1 12 1 1 1 1 12 12 1 12 12 12 12 1 1 1 1 12 1 1 1 1 12 12 12 1 1 1 1 1 1 1 12 12 1 1 1 16 16 16 16 1 1 
1 1 1 12 12 12 12 12 12 12 1 1 1 1 1 12 1 1 1 1 1 1 1 1 1 12 12 1 1 1 1 1 1 1 1 12 1 1 1 1 16 16 16 16 16 1 
1 1 1 1 12 1 1 1 1 12 1 1 1 1 1 12 1 1 1 16 16 16 16 16 16 60 60 16 16 16 16 16 16 1 1 12 1 1 1 1 1 16 16 16 1 1 
1 1 1 1 12 1 1 1 1 12 1 1 1 1 1 12 12 1 1 16 16 16 16 16 16 60 60 16 16 16 16 16 16 1 1 12 1 1 1 1 16 16 16 16 16 1 
1 1 1 1 12 12 12 12 12 12 12 1 1 1 1 12 12 1 1 1 1 0 1 1 1 12 12 1 1 1 1 1 0 1 1 12 12 1 1 1 1 16 1 16 16 1 
1 1 1 1 1 1 1 1 1 12 1 1 1 1 1 12 12 1 1 1 1 0 1 1 1 12 12 1 1 1 1 1 0 1 1 12 12 12 1 1 1 1 1 1 1 1 
1 1 1 1 1 1 1 1 1 12 1 1 1 1 1 12 12 12 12 12 12 12 12 12 1 12 12 12 1 1 1 1 12 12 12 12 12 12 12 1 1 1 1 1 1 1 
1 1 1 1 1 1 1 1 1 12 12 12 12 12 12 12 1 1 1 1 12 12 12 12 1 12 12 12 1 1 1 1 1 1 12 12 12 12 12 1 1 1 1 1 1 1 
1 1 1 1 1 1 1 1 1 1 1 1 1 1 1 1 1 1 1 1 1 1 12 12 1 12 12 12 1 1 1 1 1 1 1 1 1 12 12 1 1 16 16 16 1 1 
1 1 1 1 1 1 1 1 1 1 1 1 1 1 1 1 1 1 1 1 1 1 12 12 1 12 12 12 1 1 1 16 16 16 16 16 16 60 60 16 16 16 16 16 1 1 
1 1 1 1 1 1 1 1 1 1 12 12 12 12 12 12 13 12 12 1 1 1 1 1 1 1 12 12 1 1 1 16 16 16 16 16 16 60 60 16 16 16 16 16 1 1 
1 1 1 1 12 12 12 12 12 12 12 12 12 12 12 12 12 12 12 1 1 1 1 1 1 1 12 12 1 1 1 1 0 1 1 1 1 12 12 1 1 16 16 16 1 1 
1 1 1 12 12 12 12 12 12 12 12 12 12 12 12 12 12 1 1 1 1 1 1 1 1 1 12 12 1 1 1 1 0 1 1 1 1 12 12 1 1 16 16 16 1 1 
1 1 1 12 12 1 1 1 1 1 1 1 1 1 12 12 12 1 1 1 1 1 1 1 1 1 12 12 12 12 12 12 12 1 1 1 1 12 12 1 1 16 16 1 1 1 
1 1 1 12 12 1 1 1 1 1 1 1 1 1 12 12 12 1 1 1 1 1 12 1 1 1 1 1 12 12 12 12 1 1 1 1 1 12 12 1 1 16 16 1 1 1 
1 1 1 12 12 12 1 1 1 1 1 1 1 1 12 12 1 1 1 1 12 12 12 1 1 1 1 1 1 1 1 1 1 1 1 1 12 12 12 1 1 16 16 1 1 1 
1 1 1 12 12 1 1 1 1 1 1 1 1 1 12 12 1 1 1 1 1 1 12 1 1 1 1 1 1 1 1 1 1 1 1 12 12 12 12 1 1 16 16 1 1 1 
1 1 1 12 12 1 1 1 1 1 1 1 1 1 12 12 1 1 1 1 1 1 12 1 1 1 1 1 1 1 1 1 1 1 1 1 12 12 12 1 1 0 1 1 1 1 
1 1 1 12 12 12 1 1 1 1 1 1 1 1 12 12 1 1 1 1 1 1 12 1 1 1 1 1 1 1 1 1 1 1 1 1 12 12 12 1 1 0 1 1 1 1 
1 1 1 12 12 12 12 1 1 1 1 1 1 1 12 12 12 12 12 12 12 12 12 1 1 1 1 1 1 12 12 12 1 1 1 1 12 12 12 1 12 12 12 1 1 1 
1 1 1 1 12 12 12 1 1 1 1 1 1 1 12 12 12 12 12 12 12 12 12 1 1 1 1 1 1 12 12 12 12 12 12 12 12 12 12 1 12 12 12 1 1 1 
1 1 1 1 12 12 12 1 1 1 1 1 1 1 12 12 12 12 12 12 12 1 1 1 1 1 1 1 1 12 12 12 12 12 12 12 12 12 12 1 12 12 12 1 1 1 
1 1 1 1 1 1 1 1 1 1 1 1 1 1 1 1 1 1 1 1 1 1 1 1 1 1 1 1 1 1 1 1 1 1 1 1 1 1 1 1 1 1 1 1 1 1 
1 1 1 1 1 1 1 1 1 1 1 1 1 1 1 1 1 1 1 1 1 1 1 1 1 1 1 1 1 1 1 1 1 1 1 1 1 1 1 1 1 1 1 1 1 1 
1 1 1 1 1 1 1 1 1 1 1 1 1 1 1 1 1 1 1 1 1 1 1 1 1 1 1 1 1 1 1 1 1 1 1 1 1 1 1 1 1 1 1 1 1 1 
