Connections;
Exits;VICTORY ROAD (24.44);VICTORY ROAD (24.44);VICTORY ROAD (24.44);VICTORY ROAD (24.44);
1 1 1 1 1 1 1 1 1 1 1 1 1 1 1 1 1 1 1 1 1 1 1 1 1 1 1 1 1 1 1 1 1 1 1 1 1 1 1 1 1 1 1 1 1 1 
1 1 1 1 4 4 4 4 4 4 4 4 4 4 4 4 4 4 4 4 4 4 4 4 4 4 4 4 1 1 1 1 1 1 1 1 1 12 1 1 1 1 1 1 1 1 
1 1 1 1 4 4 4 4 4 4 4 4 4 4 4 4 4 4 4 4 4 4 4 4 4 4 4 4 1 1 1 1 1 1 1 1 1 12 12 1 1 1 1 12 12 1 
1 1 1 1 4 4 4 4 4 4 4 4 4 4 4 4 4 4 4 4 4 4 4 4 4 4 4 4 1 1 1 1 1 12 12 12 12 12 12 1 1 1 1 12 12 1 
1 1 1 1 4 4 4 4 4 4 4 4 4 4 4 4 4 4 4 4 4 4 4 4 4 4 4 4 1 1 1 1 1 12 12 12 12 12 12 12 1 1 1 12 12 1 
1 1 1 1 4 4 4 4 4 4 1 1 1 1 1 4 4 4 4 4 4 4 4 4 4 4 4 4 12 1 1 1 1 12 12 12 12 12 12 12 1 1 1 12 12 1 
1 1 1 12 12 12 12 4 4 4 1 1 1 1 1 12 12 12 12 12 12 12 12 4 4 4 4 4 12 1 1 1 1 12 12 1 1 1 12 12 12 12 12 12 12 1 
1 1 1 12 12 12 12 4 4 4 1 1 1 1 1 12 12 12 12 12 12 12 12 12 12 4 4 4 1 16 1 1 1 12 12 1 1 16 1 12 12 12 12 12 12 1 
1 12 12 12 12 12 12 4 4 4 1 1 1 12 12 12 12 12 12 12 12 12 12 12 12 4 4 4 1 1 1 1 12 12 12 1 1 1 1 12 12 12 12 12 12 1 
1 12 12 12 12 12 12 4 4 4 1 1 1 1 1 1 1 1 1 1 1 1 1 1 1 4 4 4 1 1 1 1 1 1 12 1 1 1 1 1 1 12 12 12 12 1 
1 12 12 12 12 12 12 4 4 4 1 1 1 1 1 1 1 1 1 1 1 1 1 1 1 4 4 4 1 1 1 1 1 1 12 1 1 1 12 12 1 12 12 12 12 1 
1 12 12 1 1 1 1 4 4 4 1 1 1 1 1 1 1 1 1 1 1 1 1 1 1 4 4 4 1 1 1 1 1 1 12 1 1 1 12 12 1 12 12 12 12 1 
1 12 12 1 1 1 1 4 4 4 1 1 1 1 1 4 4 4 12 12 12 4 1 1 4 4 4 4 4 4 4 4 4 12 12 12 1 1 1 1 1 12 12 12 12 1 
1 12 12 1 1 1 1 4 4 4 1 1 1 1 1 4 4 4 12 12 12 4 1 1 4 4 4 4 4 4 4 4 4 12 12 12 1 12 12 1 1 12 12 12 12 1 
1 12 12 1 1 1 4 4 4 4 4 4 4 4 4 4 4 4 4 4 4 4 4 1 1 4 4 4 4 4 4 4 4 4 4 4 1 12 12 1 1 12 12 12 12 1 
1 12 12 1 1 1 4 4 4 4 4 4 4 4 4 4 4 4 4 4 4 4 4 1 1 4 4 4 4 4 4 4 4 4 4 4 1 1 1 1 1 12 12 12 12 1 
1 12 12 1 1 1 1 1 1 1 1 1 4 4 4 4 4 4 4 4 4 1 1 1 1 1 1 1 1 1 1 1 1 4 4 4 1 1 1 12 12 12 12 12 12 1 
1 12 12 1 1 1 1 1 1 1 1 1 1 4 4 4 1 1 1 1 1 1 1 1 1 1 1 1 1 1 1 1 1 12 12 12 1 1 1 0 12 12 12 12 12 1 
1 12 12 12 12 12 0 16 16 1 1 1 1 12 12 12 1 1 1 1 1 1 1 1 16 16 16 16 16 16 16 16 16 60 60 60 16 16 16 16 0 12 12 12 12 1 
1 12 12 12 12 12 0 16 16 16 16 16 16 60 60 60 16 16 16 16 16 16 16 16 16 16 16 16 16 16 16 16 16 60 60 60 16 16 16 16 0 12 12 12 12 1 
1 1 1 1 1 1 1 16 16 16 16 16 16 60 60 60 16 16 16 16 16 16 16 16 16 16 16 16 16 1 1 1 1 12 12 12 1 1 1 1 1 1 1 1 1 1 
1 1 1 1 1 1 1 1 1 1 1 1 1 12 12 12 1 1 1 16 16 16 16 16 16 16 16 1 1 1 1 1 1 12 12 12 1 1 1 1 12 12 12 12 12 1 
1 1 1 1 1 1 1 1 1 1 1 1 1 12 12 12 1 1 1 1 1 1 1 1 1 1 1 1 1 1 1 1 1 12 12 12 1 1 1 1 12 12 12 12 12 1 
1 1 1 1 1 1 1 1 1 1 1 1 12 12 12 12 1 1 1 1 1 1 1 1 1 1 1 1 1 1 1 1 12 12 12 12 12 1 1 1 12 1 1 1 1 1 
1 1 1 1 1 1 1 12 12 12 12 12 12 12 12 12 1 1 1 1 1 1 1 1 1 1 1 1 1 1 1 1 12 12 12 12 12 1 1 1 12 1 1 1 1 1 
1 1 1 1 1 1 1 12 12 12 12 12 12 12 12 12 12 12 1 1 1 1 1 1 1 1 1 12 12 12 12 12 12 12 12 12 12 1 1 1 12 1 13 1 1 1 
1 1 1 1 1 12 12 12 12 12 12 12 12 12 12 12 12 12 1 1 1 1 1 1 1 1 1 12 12 12 12 12 12 12 12 12 12 12 12 12 12 1 13 1 1 1 
1 1 1 1 1 1 1 1 1 1 1 1 1 1 1 1 1 1 1 1 1 1 1 1 1 1 1 1 1 1 1 1 1 1 1 1 1 1 1 1 1 1 13 1 1 1 
1 1 1 1 1 1 1 1 1 1 1 1 1 1 1 1 1 1 1 1 1 1 1 1 1 1 1 1 1 1 1 1 1 1 1 1 1 1 1 1 1 1 1 1 1 1 
1 1 1 1 1 1 1 1 1 1 1 1 1 1 1 1 1 1 1 1 1 1 1 1 1 1 1 1 1 1 1 1 1 1 1 1 1 1 1 1 1 1 1 1 1 1 
1 1 1 1 1 1 1 1 1 1 1 1 1 1 1 1 1 1 1 1 1 1 1 1 1 1 1 1 1 1 1 1 1 1 1 1 1 1 1 1 1 1 1 1 1 1 
